CCAGGACATAAGGAGGCCAGGTTG -> CAGGACATAAGGAGGCCAGGTTGC
ATGCTATCGCCGGGGTTTGGTCCA -> TGCTATCGCCGGGGTTTGGTCCAC
CTACACTCTAGCGTGTCTACGTCA -> TACACTCTAGCGTGTCTACGTCAG
TGACTCGTTGCCGTGGTGTGGCGA -> GACTCGTTGCCGTGGTGTGGCGAA
ACTCTCTGGGGTATGGCTACACGT -> CTCTCTGGGGTATGGCTACACGTT
GGTACGTCCCAGGATAACCCATGC -> GTACGTCCCAGGATAACCCATGCG
CGCCGGGGTTTGGTCCACGTGACG -> GCCGGGGTTTGGTCCACGTGACGA
GTTGCCATGTGCGGCAGTTCCTCA -> TTGCCATGTGCGGCAGTTCCTCAT
GAATGAATCTGTTCTTACTAAACT -> AATGAATCTGTTCTTACTAAACTA
TCTTACTAAACTACTGTCTTGACT -> CTTACTAAACTACTGTCTTGACTC
CCCCTGAGTTATTGGGGCTATGGC -> CCCTGAGTTATTGGGGCTATGGCG
CTAAGCGGGGCCGTCGACGGGTCA -> TAAGCGGGGCCGTCGACGGGTCAT
GAATACGTTTACAGGCTCACATAT -> AATACGTTTACAGGCTCACATATA
AGCGCAACAGTTAGGACACAACAC -> GCGCAACAGTTAGGACACAACACC
TCACATATAGTTCGTACATACTTC -> CACATATAGTTCGTACATACTTCA
CAATATGTACTAATTGCTCGTCGA -> AATATGTACTAATTGCTCGTCGAC
GTTGCTCATTATCGAGGGCCTATA -> TTGCTCATTATCGAGGGCCTATAT
CAGTTCCTCATACACGTAGCGCTC -> AGTTCCTCATACACGTAGCGCTCT
GCGGTTAGGCGTAATGGAGATCCT -> CGGTTAGGCGTAATGGAGATCCTA
CGTTCTCGAAAGCTCACTGAAAGT -> GTTCTCGAAAGCTCACTGAAAGTT
AATGCACATCCGGGATGGGCGTAC -> ATGCACATCCGGGATGGGCGTACC
GCCGTGGTGTGGCGAATGCACATC -> CCGTGGTGTGGCGAATGCACATCC
CAACAGTTAGGACACAACACCAAG -> AACAGTTAGGACACAACACCAAGA
AGAGCTACCCTCCCCGCCATGGAG -> GAGCTACCCTCCCCGCCATGGAGG
TTATCAGGTGACTGGATGGCGTAG -> TATCAGGTGACTGGATGGCGTAGG
GGAGAGTGAAGGTCTGTACTAAGC -> GAGAGTGAAGGTCTGTACTAAGCG
TACTCCTGTGGGGCGGCAAGCTTA -> ACTCCTGTGGGGCGGCAAGCTTAC
GCAGATTTCAGGAAAGAACCATCA -> CAGATTTCAGGAAAGAACCATCAT
CAAGACACTTGTGGCGACGAGGGA -> AAGACACTTGTGGCGACGAGGGAG
CGGATCACTCCATTATCCCAATGT -> GGATCACTCCATTATCCCAATGTT
ATCATACGGTCCTCAGTATTATCC -> TCATACGGTCCTCAGTATTATCCT
TTTCAGAACAGCCAACCTGCATAC -> TTCAGAACAGCCAACCTGCATACA
GAGGCCAGGTTGCCATGTGCGGCA -> AGGCCAGGTTGCCATGTGCGGCAG
GATCACACAGGTTATATTTTCTCA -> ATCACACAGGTTATATTTTCTCAA
ATACGGTCCTCAGTATTATCCTTA -> TACGGTCCTCAGTATTATCCTTAG
GGTTGCGGTTAGGCGTAATGGAGA -> GTTGCGGTTAGGCGTAATGGAGAT
AGTGCCAAGCCGTAGTAGGTGTGT -> GTGCCAAGCCGTAGTAGGTGTGTA
ATGGATCGACGTTGCTCATTATCG -> TGGATCGACGTTGCTCATTATCGA
CAGTATGAGTCGATTGAACGCTAT -> AGTATGAGTCGATTGAACGCTATC
TGGAGGGCAAGCCCTCACCGCTTT -> GGAGGGCAAGCCCTCACCGCTTTT
CATCCGCTGCCTTGCACCCGTGAT -> ATCCGCTGCCTTGCACCCGTGATA
TAAGCAATCCATATCTTACTCAGT -> AAGCAATCCATATCTTACTCAGTG
CGATCTGCAGCTAGGAGGTATTTA -> GATCTGCAGCTAGGAGGTATTTAT
ATGTTTATGAGTGAATGAACCCAT -> TGTTTATGAGTGAATGAACCCATC
GGCAGTTCCTCATACACGTAGCGC -> GCAGTTCCTCATACACGTAGCGCT
AAGCCCTCACCGCTTTTTCTTCCG -> AGCCCTCACCGCTTTTTCTTCCGG
AATCGCGGGTCTTCCGGGCAAGCA -> ATCGCGGGTCTTCCGGGCAAGCAC
GCGGTCGCCATTGTATTGGAAGCC -> CGGTCGCCATTGTATTGGAAGCCG
TTAGATCACACAGGTTATATTTTC -> TAGATCACACAGGTTATATTTTCT
GTAGTAGGTGTGTATTATCAGGTG -> TAGTAGGTGTGTATTATCAGGTGA
TTCAACAGTATGAGTCGATTGAAC -> TCAACAGTATGAGTCGATTGAACG
GAAAGTCTCAACCCCCTGAGTTAT -> AAAGTCTCAACCCCCTGAGTTATT
TGGCGTAGGCCATTTGACGTACGA -> GGCGTAGGCCATTTGACGTACGAA
TCAGATTCTGTCTATCAATCCTGC -> CAGATTCTGTCTATCAATCCTGCC
GTTGCGGTTAGGCGTAATGGAGAT -> TTGCGGTTAGGCGTAATGGAGATC
CAGGTTGATGCGGATTTCTGACTC -> AGGTTGATGCGGATTTCTGACTCG
TGCACACCAGGACATAAGGAGGCC -> GCACACCAGGACATAAGGAGGCCA
CGCTTTTTCTTCCGGGGACGGCTT -> GCTTTTTCTTCCGGGGACGGCTTA
GTACTCCTGTGGGGCGGCAAGCTT -> TACTCCTGTGGGGCGGCAAGCTTA
CGTGTTTCAGAACAGCCAACCTGC -> GTGTTTCAGAACAGCCAACCTGCA
CACCGCTTTTTCTTCCGGGGACGG -> ACCGCTTTTTCTTCCGGGGACGGC
GGGTTGCGGTTAGGCGTAATGGAG -> GGTTGCGGTTAGGCGTAATGGAGA
AGGACATAAGGAGGCCAGGTTGCC -> GGACATAAGGAGGCCAGGTTGCCA
CGTGTCTACGTCAGAGGCCGAGAG -> GTGTCTACGTCAGAGGCCGAGAGC
CAGATTCGGGGCGGTGCACACCAG -> AGATTCGGGGCGGTGCACACCAGG
CGGCTTAAAGAGAATTCGAGCAAT -> GGCTTAAAGAGAATTCGAGCAATA
TCACACAGGTTATATTTTCTCAAG -> CACACAGGTTATATTTTCTCAAGC
CCCGATCATTTTATCGATTTTAGA -> CCGATCATTTTATCGATTTTAGAT
AACTACTGTCTTGACTCCTCAGAT -> ACTACTGTCTTGACTCCTCAGATT
ACTTCAATTTTAGGAAACCGTTTT -> CTTCAATTTTAGGAAACCGTTTTA
TATCCTCAGGCTACAGGAATGAAT -> ATCCTCAGGCTACAGGAATGAATC
CTACCCTCCCCGCCATGGAGGGCA -> TACCCTCCCCGCCATGGAGGGCAA
TCGACGTTGCTCATTATCGAGGGC -> CGACGTTGCTCATTATCGAGGGCC
TACCCCGTCCGTACAAGGTTCATA -> ACCCCGTCCGTACAAGGTTCATAG
ATGTACTAATTGCTCGTCGACTAA -> TGTACTAATTGCTCGTCGACTAAG
CACTGAAAGTTCTATCCTAACCGT -> ACTGAAAGTTCTATCCTAACCGTC
GCCCAGCGCAACAGTTAGGACACA -> CCCAGCGCAACAGTTAGGACACAA
TACCACATTTGTTGGAGTTATGAT -> ACCACATTTGTTGGAGTTATGATA
ACTAATTGCTCGTCGACTAAGTTC -> CTAATTGCTCGTCGACTAAGTTCA
CGCTGAGGGACCACGGATCACTCC -> GCTGAGGGACCACGGATCACTCCA
TTTACAGGCTCACATATAGTTCGT -> TTACAGGCTCACATATAGTTCGTA
CATACACGTAGCGCTCTGCCATAG -> ATACACGTAGCGCTCTGCCATAGA
CGCTAACAATTCGATAGTTATCAT -> GCTAACAATTCGATAGTTATCATA
TCAATCCTGCCCCGAGGTAACTTC -> CAATCCTGCCCCGAGGTAACTTCT
CATAAACTCGTGTTTCAGAACAGC -> ATAAACTCGTGTTTCAGAACAGCC
GGTCCACGTGACGACCAGGTGCAA -> GTCCACGTGACGACCAGGTGCAAG
GTACAAGGTTCATAGTACGTTTTT -> TACAAGGTTCATAGTACGTTTTTA
GGGATGGGCGTACCCCGTCCGTAC -> GGATGGGCGTACCCCGTCCGTACA
AGGACGTCTTAGTTGAATACGTTT -> GGACGTCTTAGTTGAATACGTTTA
GCTTTTTCTTCCGGGGACGGCTTA -> CTTTTTCTTCCGGGGACGGCTTAA
GCTTGGTATCCATAAACTCGTGTT -> CTTGGTATCCATAAACTCGTGTTT
GCTAACTGAATGGATCGACGTTGC -> CTAACTGAATGGATCGACGTTGCT
TCCGCTAACTGAATGGATCGACGT -> CCGCTAACTGAATGGATCGACGTT
TTCCGCCCATCCGCTGCCTTGCAC -> TCCGCCCATCCGCTGCCTTGCACC
TGGCCTTCCACAAACGTGTACTCG -> GGCCTTCCACAAACGTGTACTCGA
TCCGGGGACGGCTTAAAGAGAATT -> CCGGGGACGGCTTAAAGAGAATTC
ACTGGATGGCGTAGGCCATTTGAC -> CTGGATGGCGTAGGCCATTTGACG
GGATTCAGTGCCAAGCCGTAGTAG -> GATTCAGTGCCAAGCCGTAGTAGG
TTATCGATTTTAGATCACACAGGT -> TATCGATTTTAGATCACACAGGTT
CGAGGGAGGTGAGACAGGTACTCC -> GAGGGAGGTGAGACAGGTACTCCT
GGCTCACATATAGTTCGTACATAC -> GCTCACATATAGTTCGTACATACT
GCGCCGTGAGCAGATTACGAGGAC -> CGCCGTGAGCAGATTACGAGGACG
TTCTGACTCGTTGCCGTGGTGTGG -> TCTGACTCGTTGCCGTGGTGTGGC
GTCTTGAGGCCTTGACTCAGGTTG -> TCTTGAGGCCTTGACTCAGGTTGA
AGCCGCGGTACGTCCCAGGATAAC -> GCCGCGGTACGTCCCAGGATAACC
CTATGGCGGTCGCCATTGTATTGG -> TATGGCGGTCGCCATTGTATTGGA
TCTCCAGGAAGTGTTGCTGACCCG -> CTCCAGGAAGTGTTGCTGACCCGT
CTCCTCAGATTCTGTCTATCAATC -> TCCTCAGATTCTGTCTATCAATCC
TCGGTTCCGTACGTTCTCGAAAGC -> CGGTTCCGTACGTTCTCGAAAGCT
GAGGTAACTTCTTGGACCTCGGTT -> AGGTAACTTCTTGGACCTCGGTTC
GTAATTCAACAGTATGAGTCGATT -> TAATTCAACAGTATGAGTCGATTG
TGAGTTATTGGGGCTATGGCGGTC -> GAGTTATTGGGGCTATGGCGGTCG
ACGTTCTCGAAAGCTCACTGAAAG -> CGTTCTCGAAAGCTCACTGAAAGT
GCGGTACGTCCCAGGATAACCCAT -> CGGTACGTCCCAGGATAACCCATG
CGGTTAGGCGTAATGGAGATCCTA -> GGTTAGGCGTAATGGAGATCCTAA
ACGGTCCCTTTCGGATAGGGGCTT -> CGGTCCCTTTCGGATAGGGGCTTG
GGATCACTCCATTATCCCAATGTT -> GATCACTCCATTATCCCAATGTTT
CAATCCTGCCCCGAGGTAACTTCT -> AATCCTGCCCCGAGGTAACTTCTT
ACCCGTGGATAGTGTCAAATTTAT -> CCCGTGGATAGTGTCAAATTTATC
TGAGGCCTTGACTCAGGTTGATGC -> GAGGCCTTGACTCAGGTTGATGCG
GGTATCCATAAACTCGTGTTTCAG -> GTATCCATAAACTCGTGTTTCAGA
CGAGCCGCAATCGCGGGTCTTCCG -> GAGCCGCAATCGCGGGTCTTCCGG
GTTCCGTACGTTCTCGAAAGCTCA -> TTCCGTACGTTCTCGAAAGCTCAC
ATAGGAGCCGCGTTGCTCAATATG -> TAGGAGCCGCGTTGCTCAATATGT
ATCAGGTGACTGGATGGCGTAGGC -> TCAGGTGACTGGATGGCGTAGGCC
ACTACTGTCTTGACTCCTCAGATT -> CTACTGTCTTGACTCCTCAGATTC
TGTTGGAGTTATGATAAGTAGATA -> GTTGGAGTTATGATAAGTAGATAG
AAAGTAGGGTTGCGGTTAGGCGTA -> AAGTAGGGTTGCGGTTAGGCGTAA
AATGAACCCATCTCCAGGAAGTGT -> ATGAACCCATCTCCAGGAAGTGTT
GAATGGATCGACGTTGCTCATTAT -> AATGGATCGACGTTGCTCATTATC
GTAATTTTCCACAACCTAGAAGCC -> TAATTTTCCACAACCTAGAAGCCG
CGATCATTTTATCGATTTTAGATC -> GATCATTTTATCGATTTTAGATCA
GGGGCCGTCGACGGGTCATGAGAT -> GGGCCGTCGACGGGTCATGAGATC
GGACCTCGGTTCCGTACGTTCTCG -> GACCTCGGTTCCGTACGTTCTCGA
ACTCGACCTGTAGAGTACGGTCCC -> CTCGACCTGTAGAGTACGGTCCCT
AAGTAGATAGGAGCCGCGTTGCTC -> AGTAGATAGGAGCCGCGTTGCTCA
AAGCGGGGCCGTCGACGGGTCATG -> AGCGGGGCCGTCGACGGGTCATGA
CTGCATACACCACTTGGCAACAAT -> TGCATACACCACTTGGCAACAATG
TAGCGCTCTGCCATAGACTTATAC -> AGCGCTCTGCCATAGACTTATACC
GCCTTGACTCAGGTTGATGCGGAT -> CCTTGACTCAGGTTGATGCGGATT
AGGCCTTGACTCAGGTTGATGCGG -> GGCCTTGACTCAGGTTGATGCGGA
AATCCTGCCCCGAGGTAACTTCTT -> ATCCTGCCCCGAGGTAACTTCTTG
AGGCTCCTTTCCGCCCATCCGCTG -> GGCTCCTTTCCGCCCATCCGCTGC
GGGTTTGGTCCACGTGACGACCAG -> GGTTTGGTCCACGTGACGACCAGG
CATATAGTTCGTACATACTTCAAT -> ATATAGTTCGTACATACTTCAATT
CGACCTGTAGAGTACGGTCCCTTT -> GACCTGTAGAGTACGGTCCCTTTC
ATATTTTCTCAAGCATGTTTGCGC -> TATTTTCTCAAGCATGTTTGCGCC
ATACACGTAGCGCTCTGCCATAGA -> TACACGTAGCGCTCTGCCATAGAC
TGACACGTGTGTCCCGATCTGCAG -> GACACGTGTGTCCCGATCTGCAGC
CGTAGTAGGTGTGTATTATCAGGT -> GTAGTAGGTGTGTATTATCAGGTG
AAGGTTCATAGTACGTTTTTAAGC -> AGGTTCATAGTACGTTTTTAAGCG
CACGGATCACTCCATTATCCCAAT -> ACGGATCACTCCATTATCCCAATG
GCCATTGTATTGGAAGCCGCTAAC -> CCATTGTATTGGAAGCCGCTAACA
CTCAATATGTACTAATTGCTCGTC -> TCAATATGTACTAATTGCTCGTCG
CAGTCTGCAATGTATCCTCAGGCT -> AGTCTGCAATGTATCCTCAGGCTA
CCTCAGTATTATCCTTAGTTTCCC -> CTCAGTATTATCCTTAGTTTCCCT
GACGACCAGGTGCAAGGCTCCTTT -> ACGACCAGGTGCAAGGCTCCTTTC
TAACAATTCGATAGTTATCATATG -> AACAATTCGATAGTTATCATATGT
TGGAAGCCGCTAACAATTCGATAG -> GGAAGCCGCTAACAATTCGATAGT
AATCTGTTCTTACTAAACTACTGT -> ATCTGTTCTTACTAAACTACTGTC
TCTCTGGGGTATGGCTACACGTTT -> CTCTGGGGTATGGCTACACGTTTG
CCCGTGGATAGTGTCAAATTTATC -> CCGTGGATAGTGTCAAATTTATCG
TTGTACTCTCTGGGGTATGGCTAC -> TGTACTCTCTGGGGTATGGCTACA
AGTTTCCCTAGCCCAGCGCAACAG -> GTTTCCCTAGCCCAGCGCAACAGT
TAAAGGGAGAGTGAAGGTCTGTAC -> AAAGGGAGAGTGAAGGTCTGTACT
AGGCTACAGGAATGAATCTGTTCT -> GGCTACAGGAATGAATCTGTTCTT
ACAGTTAGGACACAACACCAAGAC -> CAGTTAGGACACAACACCAAGACA
AAGTAGGGTTGCGGTTAGGCGTAA -> AGTAGGGTTGCGGTTAGGCGTAAT
GCGGCAAGCTTACAGTTACTCGCC -> CGGCAAGCTTACAGTTACTCGCCT
GAACCATCATACGGTCCTCAGTAT -> AACCATCATACGGTCCTCAGTATT
ACTAAACTACTGTCTTGACTCCTC -> CTAAACTACTGTCTTGACTCCTCA
TTGTGGCGACGAGGGAGGTGAGAC -> TGTGGCGACGAGGGAGGTGAGACA
GTCCGTACAAGGTTCATAGTACGT -> TCCGTACAAGGTTCATAGTACGTT
TTCTGTCTATCAATCCTGCCCCGA -> TCTGTCTATCAATCCTGCCCCGAG
CATGCGTGATCCGAGCCGCAATCG -> ATGCGTGATCCGAGCCGCAATCGC
TTCGATAGTTATCATATGTCGGCT -> TCGATAGTTATCATATGTCGGCTC
GCCGTCGACGGGTCATGAGATCAG -> CCGTCGACGGGTCATGAGATCAGA
GTAGGTGTGTATTATCAGGTGACT -> TAGGTGTGTATTATCAGGTGACTG
CCTAGCCCAGCGCAACAGTTAGGA -> CTAGCCCAGCGCAACAGTTAGGAC
TCGCGGGTCTTCCGGGCAAGCACA -> CGCGGGTCTTCCGGGCAAGCACAT
CGGGGCCGTCGACGGGTCATGAGA -> GGGGCCGTCGACGGGTCATGAGAT
TATAGTTCGTACATACTTCAATTT -> ATAGTTCGTACATACTTCAATTTT
GCCTTCCACAAACGTGTACTCGAC -> CCTTCCACAAACGTGTACTCGACC
AACAATTCGATAGTTATCATATGT -> ACAATTCGATAGTTATCATATGTC
ACGTTTACAGGCTCACATATAGTT -> CGTTTACAGGCTCACATATAGTTC
CCGTCGTGCATGGCCTTCCACAAA -> CGTCGTGCATGGCCTTCCACAAAC
GAGATCCTAAGCAATCCATATCTT -> AGATCCTAAGCAATCCATATCTTA
TATCATATGTCGGCTCGCTACTAA -> ATCATATGTCGGCTCGCTACTAAA
AAGCTCACTGAAAGTTCTATCCTA -> AGCTCACTGAAAGTTCTATCCTAA
CTAGAAGCCGTAATTCAACAGTAT -> TAGAAGCCGTAATTCAACAGTATG
CTCTGAGAAAGTCTCAACCCCCTG -> TCTGAGAAAGTCTCAACCCCCTGA
TGGATGGCGTAGGCCATTTGACGT -> GGATGGCGTAGGCCATTTGACGTA
GTCTCAACCCCCTGAGTTATTGGG -> TCTCAACCCCCTGAGTTATTGGGG
ATATAGTTCGTACATACTTCAATT -> TATAGTTCGTACATACTTCAATTT
GTCGACGGGTCATGAGATCAGAAA -> TCGACGGGTCATGAGATCAGAAAC
TCCACAACCTAGAAGCCGTAATTC -> CCACAACCTAGAAGCCGTAATTCA
TTATCGAGGGCCTATATATTAAAT -> TATCGAGGGCCTATATATTAAATT
ACGCGGAAGCTACGTATTCCGCTA -> CGCGGAAGCTACGTATTCCGCTAA
TATTATCCTTAGTTTCCCTAGCCC -> ATTATCCTTAGTTTCCCTAGCCCA
CCGTGGATAGTGTCAAATTTATCG -> CGTGGATAGTGTCAAATTTATCGG
TCTTCCGGGGACGGCTTAAAGAGA -> CTTCCGGGGACGGCTTAAAGAGAA
TTCATCGCGGAATTGTACTCTCTG -> TCATCGCGGAATTGTACTCTCTGG
TTAGTTTCCCTAGCCCAGCGCAAC -> TAGTTTCCCTAGCCCAGCGCAACA
TTGGAAGCCGCTAACAATTCGATA -> TGGAAGCCGCTAACAATTCGATAG
GTTTCAGAACAGCCAACCTGCATA -> TTTCAGAACAGCCAACCTGCATAC
CATATCTTACTCAGTGTCGGCCCG -> ATATCTTACTCAGTGTCGGCCCGA
AGTTAGGACACAACACCAAGACAC -> GTTAGGACACAACACCAAGACACT
GCCGCGTTGCTCAATATGTACTAA -> CCGCGTTGCTCAATATGTACTAAT
CGAAAGCTCACTGAAAGTTCTATC -> GAAAGCTCACTGAAAGTTCTATCC
ACGTCAGAGGCCGAGAGCTACCCT -> CGTCAGAGGCCGAGAGCTACCCTC
AGGGACCACGGATCACTCCATTAT -> GGGACCACGGATCACTCCATTATC
AGTTGAATACGTTTACAGGCTCAC -> GTTGAATACGTTTACAGGCTCACA
GGGACCACGGATCACTCCATTATC -> GGACCACGGATCACTCCATTATCC
GCCGCAATCGCGGGTCTTCCGGGC -> CCGCAATCGCGGGTCTTCCGGGCA
CTAAGTTCATCGCGGAATTGTACT -> TAAGTTCATCGCGGAATTGTACTC
ACGTGACGACCAGGTGCAAGGCTC -> CGTGACGACCAGGTGCAAGGCTCC
AGCAGATTACGAGGACGTCTTAGT -> GCAGATTACGAGGACGTCTTAGTT
GATTTTAGATCACACAGGTTATAT -> ATTTTAGATCACACAGGTTATATT
GGAATGAATCTGTTCTTACTAAAC -> GAATGAATCTGTTCTTACTAAACT
TACTAAAGGGAGAGTGAAGGTCTG -> ACTAAAGGGAGAGTGAAGGTCTGT
TACGTCCCAGGATAACCCATGCGT -> ACGTCCCAGGATAACCCATGCGTG
AGAACAGCCAACCTGCATACACCA -> GAACAGCCAACCTGCATACACCAC
TTCTTACTAAACTACTGTCTTGAC -> TCTTACTAAACTACTGTCTTGACT
CCATGTGCGGCAGTTCCTCATACA -> CATGTGCGGCAGTTCCTCATACAC
TGACGCTAAATCACCCGTGGATAG -> GACGCTAAATCACCCGTGGATAGT
GTGTGTATTATCAGGTGACTGGAT -> TGTGTATTATCAGGTGACTGGATG
GAATGCACATCCGGGATGGGCGTA -> AATGCACATCCGGGATGGGCGTAC
GTTCATCGCGGAATTGTACTCTCT -> TTCATCGCGGAATTGTACTCTCTG
GCCCTCACCGCTTTTTCTTCCGGG -> CCCTCACCGCTTTTTCTTCCGGGG
GGTTTGGTCCACGTGACGACCAGG -> GTTTGGTCCACGTGACGACCAGGT
CGCGGAATTGTACTCTCTGGGGTA -> GCGGAATTGTACTCTCTGGGGTAT
CATAAGGAGGCCAGGTTGCCATGT -> ATAAGGAGGCCAGGTTGCCATGTG
CCATAAACTCGTGTTTCAGAACAG -> CATAAACTCGTGTTTCAGAACAGC
ACATAAGGAGGCCAGGTTGCCATG -> CATAAGGAGGCCAGGTTGCCATGT
CGTGATCCGAGCCGCAATCGCGGG -> GTGATCCGAGCCGCAATCGCGGGT
ACCTGCATACACCACTTGGCAACA -> CCTGCATACACCACTTGGCAACAA
GAAACGCGCCGTGAGCAGATTACG -> AAACGCGCCGTGAGCAGATTACGA
TGGCAACAATGTGACACGTGTGTC -> GGCAACAATGTGACACGTGTGTCC
CCGAGAGCTACCCTCCCCGCCATG -> CGAGAGCTACCCTCCCCGCCATGG
GCGCTCTGCCATAGACTTATACCA -> CGCTCTGCCATAGACTTATACCAC
CCGGGGACGGCTTAAAGAGAATTC -> CGGGGACGGCTTAAAGAGAATTCG
GCCTTGCACCCGTGATAGCCGCGG -> CCTTGCACCCGTGATAGCCGCGGT
CCAAGCCGTAGTAGGTGTGTATTA -> CAAGCCGTAGTAGGTGTGTATTAT
ATTATCGAGGGCCTATATATTAAA -> TTATCGAGGGCCTATATATTAAAT
TCGAGCAATAAATTAGTGTAACTA -> CGAGCAATAAATTAGTGTAACTAG
TCTGACTCGTTGCCGTGGTGTGGC -> CTGACTCGTTGCCGTGGTGTGGCG
ACAACACCAAGACACTTGTGGCGA -> CAACACCAAGACACTTGTGGCGAC
TTCAATTTTAGGAAACCGTTTTAG -> TCAATTTTAGGAAACCGTTTTAGG
TGGGGTATGGCTACACGTTTGTGA -> GGGGTATGGCTACACGTTTGTGAC
TTGCCGTGGTGTGGCGAATGCACA -> TGCCGTGGTGTGGCGAATGCACAT
CCAAGACACTTGTGGCGACGAGGG -> CAAGACACTTGTGGCGACGAGGGA
CTACTAAAGGGAGAGTGAAGGTCT -> TACTAAAGGGAGAGTGAAGGTCTG
TACTAAACTACTGTCTTGACTCCT -> ACTAAACTACTGTCTTGACTCCTC
TATGTTTATGAGTGAATGAACCCA -> ATGTTTATGAGTGAATGAACCCAT
AGATTCGGGGCGGTGCACACCAGG -> GATTCGGGGCGGTGCACACCAGGA
TAATTCAACAGTATGAGTCGATTG -> AATTCAACAGTATGAGTCGATTGA
CCGCAATCGCGGGTCTTCCGGGCA -> CGCAATCGCGGGTCTTCCGGGCAA
GCCCGATCATTTTATCGATTTTAG -> CCCGATCATTTTATCGATTTTAGA
CAGTGCCAAGCCGTAGTAGGTGTG -> AGTGCCAAGCCGTAGTAGGTGTGT
GAGAGTGAAGGTCTGTACTAAGCG -> AGAGTGAAGGTCTGTACTAAGCGG
GTCAGAGGCCGAGAGCTACCCTCC -> TCAGAGGCCGAGAGCTACCCTCCC
GTTTGTGACGCTAAATCACCCGTG -> TTTGTGACGCTAAATCACCCGTGG
TGAGACAGGTACTCCTGTGGGGCG -> GAGACAGGTACTCCTGTGGGGCGG
AGAGTACGGTCCCTTTCGGATAGG -> GAGTACGGTCCCTTTCGGATAGGG
GGTTCCGTACGTTCTCGAAAGCTC -> GTTCCGTACGTTCTCGAAAGCTCA
CGGCCCGATCATTTTATCGATTTT -> GGCCCGATCATTTTATCGATTTTA
AGGTTGCCATGTGCGGCAGTTCCT -> GGTTGCCATGTGCGGCAGTTCCTC
GAGATCAGAAACGCGCCGTGAGCA -> AGATCAGAAACGCGCCGTGAGCAG
TAGGGTTGCGGTTAGGCGTAATGG -> AGGGTTGCGGTTAGGCGTAATGGA
TCTGTACTAAGCGGGGCCGTCGAC -> CTGTACTAAGCGGGGCCGTCGACG
CAATTCGATAGTTATCATATGTCG -> AATTCGATAGTTATCATATGTCGG
GTTTCCCTAGCCCAGCGCAACAGT -> TTTCCCTAGCCCAGCGCAACAGTT
ACCACATTTGTTGGAGTTATGATA -> CCACATTTGTTGGAGTTATGATAA
CGTTGCCGTGGTGTGGCGAATGCA -> GTTGCCGTGGTGTGGCGAATGCAC
GTTGGAGTTATGATAAGTAGATAG -> TTGGAGTTATGATAAGTAGATAGG
GTTCTATCCTAACCGTCGTGCATG -> TTCTATCCTAACCGTCGTGCATGG
GACTCGTTGCCGTGGTGTGGCGAA -> ACTCGTTGCCGTGGTGTGGCGAAT
CCCCGTCCGTACAAGGTTCATAGT -> CCCGTCCGTACAAGGTTCATAGTA
TGAAAGTTCTATCCTAACCGTCGT -> GAAAGTTCTATCCTAACCGTCGTG
TTGGTCCACGTGACGACCAGGTGC -> TGGTCCACGTGACGACCAGGTGCA
GGCCAGGTTGCCATGTGCGGCAGT -> GCCAGGTTGCCATGTGCGGCAGTT
ACGTAGCGCTCTGCCATAGACTTA -> CGTAGCGCTCTGCCATAGACTTAT
TATATTTTCTCAAGCATGTTTGCG -> ATATTTTCTCAAGCATGTTTGCGC
TCGGCCCGATCATTTTATCGATTT -> CGGCCCGATCATTTTATCGATTTT
CCTGTGGGGCGGCAAGCTTACAGT -> CTGTGGGGCGGCAAGCTTACAGTT
AAGTGTTGCTGACCCGTCTTGAGG -> AGTGTTGCTGACCCGTCTTGAGGC
AACAGTTAGGACACAACACCAAGA -> ACAGTTAGGACACAACACCAAGAC
CACCAGGACATAAGGAGGCCAGGT -> ACCAGGACATAAGGAGGCCAGGTT
GTATCCTCAGGCTACAGGAATGAA -> TATCCTCAGGCTACAGGAATGAAT
CCGCGTTGCTCAATATGTACTAAT -> CGCGTTGCTCAATATGTACTAATT
CAAGGCTCCTTTCCGCCCATCCGC -> AAGGCTCCTTTCCGCCCATCCGCT
GTGCTCCTCACGCGGAAGCTACGT -> TGCTCCTCACGCGGAAGCTACGTA
GATCTGCAGCTAGGAGGTATTTAT -> ATCTGCAGCTAGGAGGTATTTATG
CCATCATACGGTCCTCAGTATTAT -> CATCATACGGTCCTCAGTATTATC
GGAAGCCGCTAACAATTCGATAGT -> GAAGCCGCTAACAATTCGATAGTT
TTTCCGCCCATCCGCTGCCTTGCA -> TTCCGCCCATCCGCTGCCTTGCAC
GAGAAAGTCTCAACCCCCTGAGTT -> AGAAAGTCTCAACCCCCTGAGTTA
AGGAAGTGTTGCTGACCCGTCTTG -> GGAAGTGTTGCTGACCCGTCTTGA
GTAGGCCATTTGACGTACGAAAGA -> TAGGCCATTTGACGTACGAAAGAT
CACATTTGTTGGAGTTATGATAAG -> ACATTTGTTGGAGTTATGATAAGT
ACCAGGTGCAAGGCTCCTTTCCGC -> CCAGGTGCAAGGCTCCTTTCCGCC
TGGCGACGAGGGAGGTGAGACAGG -> GGCGACGAGGGAGGTGAGACAGGT
GATTGAACGCTATCAAGCAGATTC -> ATTGAACGCTATCAAGCAGATTCG
CAAGCAGATTCGGGGCGGTGCACA -> AAGCAGATTCGGGGCGGTGCACAC
CGTCTTAGTTGAATACGTTTACAG -> GTCTTAGTTGAATACGTTTACAGG
ATGCGTGATCCGAGCCGCAATCGC -> TGCGTGATCCGAGCCGCAATCGCG
TATCCATAAACTCGTGTTTCAGAA -> ATCCATAAACTCGTGTTTCAGAAC
TTTCTCAAGCATGTTTGCGCCGGC -> TTCTCAAGCATGTTTGCGCCGGCA
CAATGTGACACGTGTGTCCCGATC -> AATGTGACACGTGTGTCCCGATCT
AAGCACATTGAGACTACACTCTAG -> AGCACATTGAGACTACACTCTAGC
GGTGCAAGGCTCCTTTCCGCCCAT -> GTGCAAGGCTCCTTTCCGCCCATC
CTAAGCAATCCATATCTTACTCAG -> TAAGCAATCCATATCTTACTCAGT
AGGAGGTATTTATGTTTATGAGTG -> GGAGGTATTTATGTTTATGAGTGA
TGTACTAATTGCTCGTCGACTAAG -> GTACTAATTGCTCGTCGACTAAGT
CGGTCCTCAGTATTATCCTTAGTT -> GGTCCTCAGTATTATCCTTAGTTT
TATGGCGGTCGCCATTGTATTGGA -> ATGGCGGTCGCCATTGTATTGGAA
CGAGGACGTCTTAGTTGAATACGT -> GAGGACGTCTTAGTTGAATACGTT
CGTCAGAGGCCGAGAGCTACCCTC -> GTCAGAGGCCGAGAGCTACCCTCC
CACGTGACGACCAGGTGCAAGGCT -> ACGTGACGACCAGGTGCAAGGCTC
GTACTCTCTGGGGTATGGCTACAC -> TACTCTCTGGGGTATGGCTACACG
TCCTCAGATTCTGTCTATCAATCC -> CCTCAGATTCTGTCTATCAATCCT
TATTATCAGGTGACTGGATGGCGT -> ATTATCAGGTGACTGGATGGCGTA
GCGTAGGCCATTTGACGTACGAAA -> CGTAGGCCATTTGACGTACGAAAG
CCCGTGATAGCCGCGGTACGTCCC -> CCGTGATAGCCGCGGTACGTCCCA
ACTCCATTATCCCAATGTTTGTGG -> CTCCATTATCCCAATGTTTGTGGT
CTAACTGAATGGATCGACGTTGCT -> TAACTGAATGGATCGACGTTGCTC
GGCGTAGGCCATTTGACGTACGAA -> GCGTAGGCCATTTGACGTACGAAA
CAACAGTATGAGTCGATTGAACGC -> AACAGTATGAGTCGATTGAACGCT
TCGAAAGCTCACTGAAAGTTCTAT -> CGAAAGCTCACTGAAAGTTCTATC
GGGCGTACCCCGTCCGTACAAGGT -> GGCGTACCCCGTCCGTACAAGGTT
GACCTCGGTTCCGTACGTTCTCGA -> ACCTCGGTTCCGTACGTTCTCGAA
GCTGACCCGTCTTGAGGCCTTGAC -> CTGACCCGTCTTGAGGCCTTGACT
GGACACAACACCAAGACACTTGTG -> GACACAACACCAAGACACTTGTGG
GATTCGGGGCGGTGCACACCAGGA -> ATTCGGGGCGGTGCACACCAGGAC
TACGTCAGAGGCCGAGAGCTACCC -> ACGTCAGAGGCCGAGAGCTACCCT
CCATTATCCCAATGTTTGTGGTAA -> CATTATCCCAATGTTTGTGGTAAA
TAGGGATGCTATCGCCGGGGTTTG -> AGGGATGCTATCGCCGGGGTTTGG
CGCCGTGAGCAGATTACGAGGACG -> GCCGTGAGCAGATTACGAGGACGT
CCAGGAAGTGTTGCTGACCCGTCT -> CAGGAAGTGTTGCTGACCCGTCTT
TAGGTGTGTATTATCAGGTGACTG -> AGGTGTGTATTATCAGGTGACTGG
CTACACGTTTGTGACGCTAAATCA -> TACACGTTTGTGACGCTAAATCAC
TGCACATCCGGGATGGGCGTACCC -> GCACATCCGGGATGGGCGTACCCC
CGTCGACTAAGTTCATCGCGGAAT -> GTCGACTAAGTTCATCGCGGAATT
GTATTGGAAGCCGCTAACAATTCG -> TATTGGAAGCCGCTAACAATTCGA
AAGTCTCAACCCCCTGAGTTATTG -> AGTCTCAACCCCCTGAGTTATTGG
GGCGTACCCCGTCCGTACAAGGTT -> GCGTACCCCGTCCGTACAAGGTTC
AATACGTTTACAGGCTCACATATA -> ATACGTTTACAGGCTCACATATAG
TGGCGGTCGCCATTGTATTGGAAG -> GGCGGTCGCCATTGTATTGGAAGC
TCAGGAAAGAACCATCATACGGTC -> CAGGAAAGAACCATCATACGGTCC
GGGCTATGGCGGTCGCCATTGTAT -> GGCTATGGCGGTCGCCATTGTATT
ATGGCGGTCGCCATTGTATTGGAA -> TGGCGGTCGCCATTGTATTGGAAG
AGGAATGAATCTGTTCTTACTAAA -> GGAATGAATCTGTTCTTACTAAAC
CCTGCCCCGAGGTAACTTCTTGGA -> CTGCCCCGAGGTAACTTCTTGGAC
GGCAAGCACATTGAGACTACACTC -> GCAAGCACATTGAGACTACACTCT
AGTCTGCAATGTATCCTCAGGCTA -> GTCTGCAATGTATCCTCAGGCTAC
ACTCAGTGTCGGCCCGATCATTTT -> CTCAGTGTCGGCCCGATCATTTTA
GCACATCCGGGATGGGCGTACCCC -> CACATCCGGGATGGGCGTACCCCG
CGACCAGGTGCAAGGCTCCTTTCC -> GACCAGGTGCAAGGCTCCTTTCCG
AACGCTATCAAGCAGATTCGGGGC -> ACGCTATCAAGCAGATTCGGGGCG
TCATGAGATCAGAAACGCGCCGTG -> CATGAGATCAGAAACGCGCCGTGA
GGCTTGGTATCCATAAACTCGTGT -> GCTTGGTATCCATAAACTCGTGTT
CGCGCCGTGAGCAGATTACGAGGA -> GCGCCGTGAGCAGATTACGAGGAC
CTAAAGGGAGAGTGAAGGTCTGTA -> TAAAGGGAGAGTGAAGGTCTGTAC
GCAACAATGTGACACGTGTGTCCC -> CAACAATGTGACACGTGTGTCCCG
GTGTCCCGATCTGCAGCTAGGAGG -> TGTCCCGATCTGCAGCTAGGAGGT
ACCTCGGTTCCGTACGTTCTCGAA -> CCTCGGTTCCGTACGTTCTCGAAA
CTTCCGGGGACGGCTTAAAGAGAA -> TTCCGGGGACGGCTTAAAGAGAAT
TAGGCGTAATGGAGATCCTAAGCA -> AGGCGTAATGGAGATCCTAAGCAA
TGAGTCGATTGAACGCTATCAAGC -> GAGTCGATTGAACGCTATCAAGCA
TGCTGACCCGTCTTGAGGCCTTGA -> GCTGACCCGTCTTGAGGCCTTGAC
ATTCCGCTAACTGAATGGATCGAC -> TTCCGCTAACTGAATGGATCGACG
TGACGTACGAAAGATAGTTAACGC -> GACGTACGAAAGATAGTTAACGCT
GAGAATTCGAGCAATAAATTAGTG -> AGAATTCGAGCAATAAATTAGTGT
AAGACACTTGTGGCGACGAGGGAG -> AGACACTTGTGGCGACGAGGGAGG
GAAGCTACGTATTCCGCTAACTGA -> AAGCTACGTATTCCGCTAACTGAA
TCCCCGCCATGGAGGGCAAGCCCT -> CCCCGCCATGGAGGGCAAGCCCTC
TTCGTACATACTTCAATTTTAGGA -> TCGTACATACTTCAATTTTAGGAA
CTGAATGGATCGACGTTGCTCATT -> TGAATGGATCGACGTTGCTCATTA
TACAGGAATGAATCTGTTCTTACT -> ACAGGAATGAATCTGTTCTTACTA
ATCGCGGGTCTTCCGGGCAAGCAC -> TCGCGGGTCTTCCGGGCAAGCACA
CCGTGGTGTGGCGAATGCACATCC -> CGTGGTGTGGCGAATGCACATCCG
GAACGCTATCAAGCAGATTCGGGG -> AACGCTATCAAGCAGATTCGGGGC
CCTCACCGCTTTTTCTTCCGGGGA -> CTCACCGCTTTTTCTTCCGGGGAC
GGCCTTGACTCAGGTTGATGCGGA -> GCCTTGACTCAGGTTGATGCGGAT
TGTATCCTCAGGCTACAGGAATGA -> GTATCCTCAGGCTACAGGAATGAA
TCGCCATTGTATTGGAAGCCGCTA -> CGCCATTGTATTGGAAGCCGCTAA
ATCCTGCCCCGAGGTAACTTCTTG -> TCCTGCCCCGAGGTAACTTCTTGG
TGTTTGTGGTAAAAGTAGGGTTGC -> GTTTGTGGTAAAAGTAGGGTTGCG
CGGTACGTCCCAGGATAACCCATG -> GGTACGTCCCAGGATAACCCATGC
TATCGGCGTGCTCCTCACGCGGAA -> ATCGGCGTGCTCCTCACGCGGAAG
GAGCAATAAATTAGTGTAACTAGT -> AGCAATAAATTAGTGTAACTAGTA
ATAGTTCGTACATACTTCAATTTT -> TAGTTCGTACATACTTCAATTTTA
ATAGTGTCAAATTTATCGGCGTGC -> TAGTGTCAAATTTATCGGCGTGCT
CGAGGTAACTTCTTGGACCTCGGT -> GAGGTAACTTCTTGGACCTCGGTT
GACACAACACCAAGACACTTGTGG -> ACACAACACCAAGACACTTGTGGC
GACGTTGCTCATTATCGAGGGCCT -> ACGTTGCTCATTATCGAGGGCCTA
CTCCTGTGGGGCGGCAAGCTTACA -> TCCTGTGGGGCGGCAAGCTTACAG
AAGTTCATCGCGGAATTGTACTCT -> AGTTCATCGCGGAATTGTACTCTC
CTAATTGCTCGTCGACTAAGTTCA -> TAATTGCTCGTCGACTAAGTTCAT
ATTGGGGCTATGGCGGTCGCCATT -> TTGGGGCTATGGCGGTCGCCATTG
CCCTCACCGCTTTTTCTTCCGGGG -> CCTCACCGCTTTTTCTTCCGGGGA
TATTGGGGCTATGGCGGTCGCCAT -> ATTGGGGCTATGGCGGTCGCCATT
CAGGACATAAGGAGGCCAGGTTGC -> AGGACATAAGGAGGCCAGGTTGCC
ATCGATTTTAGATCACACAGGTTA -> TCGATTTTAGATCACACAGGTTAT
GCGGCAGTTCCTCATACACGTAGC -> CGGCAGTTCCTCATACACGTAGCG
CTATCCTAACCGTCGTGCATGGCC -> TATCCTAACCGTCGTGCATGGCCT
GGCCTTCCACAAACGTGTACTCGA -> GCCTTCCACAAACGTGTACTCGAC
CCGTGAGCAGATTACGAGGACGTC -> CGTGAGCAGATTACGAGGACGTCT
AACAGTATGAGTCGATTGAACGCT -> ACAGTATGAGTCGATTGAACGCTA
TTCGGGGCGGTGCACACCAGGACA -> TCGGGGCGGTGCACACCAGGACAT
GGATGGGCGTACCCCGTCCGTACA -> GATGGGCGTACCCCGTCCGTACAA
ACAATTCGATAGTTATCATATGTC -> CAATTCGATAGTTATCATATGTCG
AGGTTGATGCGGATTTCTGACTCG -> GGTTGATGCGGATTTCTGACTCGT
CGGGCAAGCACATTGAGACTACAC -> GGGCAAGCACATTGAGACTACACT
GATAGCCGCGGTACGTCCCAGGAT -> ATAGCCGCGGTACGTCCCAGGATA
TAGTAGGTGTGTATTATCAGGTGA -> AGTAGGTGTGTATTATCAGGTGAC
TCTTGAGGCCTTGACTCAGGTTGA -> CTTGAGGCCTTGACTCAGGTTGAT
CCAATGTTTGTGGTAAAAGTAGGG -> CAATGTTTGTGGTAAAAGTAGGGT
TCCGAGCCGCAATCGCGGGTCTTC -> CCGAGCCGCAATCGCGGGTCTTCC
CTTTCCGCCCATCCGCTGCCTTGC -> TTTCCGCCCATCCGCTGCCTTGCA
GTCGTGCATGGCCTTCCACAAACG -> TCGTGCATGGCCTTCCACAAACGT
TGGGGCGGCAAGCTTACAGTTACT -> GGGGCGGCAAGCTTACAGTTACTC
GCAATGTATCCTCAGGCTACAGGA -> CAATGTATCCTCAGGCTACAGGAA
GTACGGTCCCTTTCGGATAGGGGC -> TACGGTCCCTTTCGGATAGGGGCT
CGGCAAGCTTACAGTTACTCGCCT -> GGCAAGCTTACAGTTACTCGCCTC
TCAGAAACGCGCCGTGAGCAGATT -> CAGAAACGCGCCGTGAGCAGATTA
ATTTCAGGAAAGAACCATCATACG -> TTTCAGGAAAGAACCATCATACGG
AGCGGGATTCAGTGCCAAGCCGTA -> GCGGGATTCAGTGCCAAGCCGTAG
GGTCTTCCGGGCAAGCACATTGAG -> GTCTTCCGGGCAAGCACATTGAGA
GTGACGCTAAATCACCCGTGGATA -> TGACGCTAAATCACCCGTGGATAG
TTGGACCTCGGTTCCGTACGTTCT -> TGGACCTCGGTTCCGTACGTTCTC
TTACTCGCCTCTCTGAGAAAGTCT -> TACTCGCCTCTCTGAGAAAGTCTC
AAAGAACCATCATACGGTCCTCAG -> AAGAACCATCATACGGTCCTCAGT
GGAGGTATTTATGTTTATGAGTGA -> GAGGTATTTATGTTTATGAGTGAA
ATCCTAAGCAATCCATATCTTACT -> TCCTAAGCAATCCATATCTTACTC
GGGAGAGTGAAGGTCTGTACTAAG -> GGAGAGTGAAGGTCTGTACTAAGC
ATCGCGGAATTGTACTCTCTGGGG -> TCGCGGAATTGTACTCTCTGGGGT
AACCGTTTTAGGGATGCTATCGCC -> ACCGTTTTAGGGATGCTATCGCCG
GTGATAGCCGCGGTACGTCCCAGG -> TGATAGCCGCGGTACGTCCCAGGA
CATACGGTCCTCAGTATTATCCTT -> ATACGGTCCTCAGTATTATCCTTA
TCCTGCCCCGAGGTAACTTCTTGG -> CCTGCCCCGAGGTAACTTCTTGGA
TTGCACCCGTGATAGCCGCGGTAC -> TGCACCCGTGATAGCCGCGGTACG
CACATTGAGACTACACTCTAGCGT -> ACATTGAGACTACACTCTAGCGTG
CGTCGACGGGTCATGAGATCAGAA -> GTCGACGGGTCATGAGATCAGAAA
CGTAGCGCTCTGCCATAGACTTAT -> GTAGCGCTCTGCCATAGACTTATA
ATGTGACACGTGTGTCCCGATCTG -> TGTGACACGTGTGTCCCGATCTGC
AACCCATGCGTGATCCGAGCCGCA -> ACCCATGCGTGATCCGAGCCGCAA
GGGGACGGCTTAAAGAGAATTCGA -> GGGACGGCTTAAAGAGAATTCGAG
GCAGCTAGGAGGTATTTATGTTTA -> CAGCTAGGAGGTATTTATGTTTAT
GTCTGCAATGTATCCTCAGGCTAC -> TCTGCAATGTATCCTCAGGCTACA
CAGGTTGCCATGTGCGGCAGTTCC -> AGGTTGCCATGTGCGGCAGTTCCT
GATAACCCATGCGTGATCCGAGCC -> ATAACCCATGCGTGATCCGAGCCG
TACTCGCCTCTCTGAGAAAGTCTC -> ACTCGCCTCTCTGAGAAAGTCTCA
CGCGGGTCTTCCGGGCAAGCACAT -> GCGGGTCTTCCGGGCAAGCACATT
CGTATTCCGCTAACTGAATGGATC -> GTATTCCGCTAACTGAATGGATCG
CGCCTCTCTGAGAAAGTCTCAACC -> GCCTCTCTGAGAAAGTCTCAACCC
TACTAAGCGGGGCCGTCGACGGGT -> ACTAAGCGGGGCCGTCGACGGGTC
TGAGATCAGAAACGCGCCGTGAGC -> GAGATCAGAAACGCGCCGTGAGCA
AGCGTGTCTACGTCAGAGGCCGAG -> GCGTGTCTACGTCAGAGGCCGAGA
ATCCTTAGTTTCCCTAGCCCAGCG -> TCCTTAGTTTCCCTAGCCCAGCGC
TTAAAGAGAATTCGAGCAATAAAT -> TAAAGAGAATTCGAGCAATAAATT
TCATTATCGAGGGCCTATATATTA -> CATTATCGAGGGCCTATATATTAA
GGCTACACGTTTGTGACGCTAAAT -> GCTACACGTTTGTGACGCTAAATC
TCAGGTTGATGCGGATTTCTGACT -> CAGGTTGATGCGGATTTCTGACTC
TGTGGCGAATGCACATCCGGGATG -> GTGGCGAATGCACATCCGGGATGG
CGGTCCCTTTCGGATAGGGGCTTG -> GGTCCCTTTCGGATAGGGGCTTGG
TATTTATGTTTATGAGTGAATGAA -> ATTTATGTTTATGAGTGAATGAAC
CGTGCATGGCCTTCCACAAACGTG -> GTGCATGGCCTTCCACAAACGTGT
AGTTAACGCTGAGGGACCACGGAT -> GTTAACGCTGAGGGACCACGGATC
CCTCTCTGAGAAAGTCTCAACCCC -> CTCTCTGAGAAAGTCTCAACCCCC
GAGACTACACTCTAGCGTGTCTAC -> AGACTACACTCTAGCGTGTCTACG
GGGCAAGCCCTCACCGCTTTTTCT -> GGCAAGCCCTCACCGCTTTTTCTT
TCGATTTTAGATCACACAGGTTAT -> CGATTTTAGATCACACAGGTTATA
AATTCAACAGTATGAGTCGATTGA -> ATTCAACAGTATGAGTCGATTGAA
ACGCTAAATCACCCGTGGATAGTG -> CGCTAAATCACCCGTGGATAGTGT
CTCAGTGTCGGCCCGATCATTTTA -> TCAGTGTCGGCCCGATCATTTTAT
CTAGTAATTTTCCACAACCTAGAA -> TAGTAATTTTCCACAACCTAGAAG
GGACGGCTTAAAGAGAATTCGAGC -> GACGGCTTAAAGAGAATTCGAGCA
TTATGTTTATGAGTGAATGAACCC -> TATGTTTATGAGTGAATGAACCCA
AACAATGTGACACGTGTGTCCCGA -> ACAATGTGACACGTGTGTCCCGAT
TTCGGATAGGGGCTTGGTATCCAT -> TCGGATAGGGGCTTGGTATCCATA
CACACAGGTTATATTTTCTCAAGC -> ACACAGGTTATATTTTCTCAAGCA
CACCACTTGGCAACAATGTGACAC -> ACCACTTGGCAACAATGTGACACG
TAGATCACACAGGTTATATTTTCT -> AGATCACACAGGTTATATTTTCTC
TTATCATATGTCGGCTCGCTACTA -> TATCATATGTCGGCTCGCTACTAA
ACATACTTCAATTTTAGGAAACCG -> CATACTTCAATTTTAGGAAACCGT
GGTGACTGGATGGCGTAGGCCATT -> GTGACTGGATGGCGTAGGCCATTT
CTAAATCACCCGTGGATAGTGTCA -> TAAATCACCCGTGGATAGTGTCAA
ATGAACCCATCTCCAGGAAGTGTT -> TGAACCCATCTCCAGGAAGTGTTG
CAATCGCGGGTCTTCCGGGCAAGC -> AATCGCGGGTCTTCCGGGCAAGCA
CACAACCTAGAAGCCGTAATTCAA -> ACAACCTAGAAGCCGTAATTCAAC
CGTCTTGAGGCCTTGACTCAGGTT -> GTCTTGAGGCCTTGACTCAGGTTG
GTGTTGCTGACCCGTCTTGAGGCC -> TGTTGCTGACCCGTCTTGAGGCCT
TGCTCATTATCGAGGGCCTATATA -> GCTCATTATCGAGGGCCTATATAT
TCAGTGTCGGCCCGATCATTTTAT -> CAGTGTCGGCCCGATCATTTTATC
TTATGATAAGTAGATAGGAGCCGC -> TATGATAAGTAGATAGGAGCCGCG
TCATACGGTCCTCAGTATTATCCT -> CATACGGTCCTCAGTATTATCCTT
TCTTGGACCTCGGTTCCGTACGTT -> CTTGGACCTCGGTTCCGTACGTTC
ACCAAGACACTTGTGGCGACGAGG -> CCAAGACACTTGTGGCGACGAGGG
GGTGTGTATTATCAGGTGACTGGA -> GTGTGTATTATCAGGTGACTGGAT
TGTTTGCGCCGGCAGATTTCAGGA -> GTTTGCGCCGGCAGATTTCAGGAA
TCAATATGTACTAATTGCTCGTCG -> CAATATGTACTAATTGCTCGTCGA
GTAGAGTACGGTCCCTTTCGGATA -> TAGAGTACGGTCCCTTTCGGATAG
TTTCCCTAGCCCAGCGCAACAGTT -> TTCCCTAGCCCAGCGCAACAGTTA
CTAGGAGGTATTTATGTTTATGAG -> TAGGAGGTATTTATGTTTATGAGT
CGCCGGCAGATTTCAGGAAAGAAC -> GCCGGCAGATTTCAGGAAAGAACC
GACACGTGTGTCCCGATCTGCAGC -> ACACGTGTGTCCCGATCTGCAGCT
TGCCAAGCCGTAGTAGGTGTGTAT -> GCCAAGCCGTAGTAGGTGTGTATT
CAGCCAACCTGCATACACCACTTG -> AGCCAACCTGCATACACCACTTGG
TGAATCTGTTCTTACTAAACTACT -> GAATCTGTTCTTACTAAACTACTG
GAGGCCTTGACTCAGGTTGATGCG -> AGGCCTTGACTCAGGTTGATGCGG
GACTCCTCAGATTCTGTCTATCAA -> ACTCCTCAGATTCTGTCTATCAAT
TTGTTGGAGTTATGATAAGTAGAT -> TGTTGGAGTTATGATAAGTAGATA
GTAATGGAGATCCTAAGCAATCCA -> TAATGGAGATCCTAAGCAATCCAT
GCGAATGCACATCCGGGATGGGCG -> CGAATGCACATCCGGGATGGGCGT
ACTTGTGGCGACGAGGGAGGTGAG -> CTTGTGGCGACGAGGGAGGTGAGA
ACTCGTGTTTCAGAACAGCCAACC -> CTCGTGTTTCAGAACAGCCAACCT
GCTTACAGTTACTCGCCTCTCTGA -> CTTACAGTTACTCGCCTCTCTGAG
TTTATGAGTGAATGAACCCATCTC -> TTATGAGTGAATGAACCCATCTCC
ATCCATAAACTCGTGTTTCAGAAC -> TCCATAAACTCGTGTTTCAGAACA
AAAGGGAGAGTGAAGGTCTGTACT -> AAGGGAGAGTGAAGGTCTGTACTA
TCCTGTGGGGCGGCAAGCTTACAG -> CCTGTGGGGCGGCAAGCTTACAGT
TCAGAACAGCCAACCTGCATACAC -> CAGAACAGCCAACCTGCATACACC
ATTGGAAGCCGCTAACAATTCGAT -> TTGGAAGCCGCTAACAATTCGATA
TCTGCAATGTATCCTCAGGCTACA -> CTGCAATGTATCCTCAGGCTACAG
CCTCAGATTCTGTCTATCAATCCT -> CTCAGATTCTGTCTATCAATCCTG
CCCGAGGTAACTTCTTGGACCTCG -> CCGAGGTAACTTCTTGGACCTCGG
ACCGTCGTGCATGGCCTTCCACAA -> CCGTCGTGCATGGCCTTCCACAAA
TAGTTTCCCTAGCCCAGCGCAACA -> AGTTTCCCTAGCCCAGCGCAACAG
TCCTCAGGCTACAGGAATGAATCT -> CCTCAGGCTACAGGAATGAATCTG
GACGCTAAATCACCCGTGGATAGT -> ACGCTAAATCACCCGTGGATAGTG
CCATTTGACGTACGAAAGATAGTT -> CATTTGACGTACGAAAGATAGTTA
GGTCTGTACTAAGCGGGGCCGTCG -> GTCTGTACTAAGCGGGGCCGTCGA
TGTTTATGAGTGAATGAACCCATC -> GTTTATGAGTGAATGAACCCATCT
GAGGGACCACGGATCACTCCATTA -> AGGGACCACGGATCACTCCATTAT
ATGCACATCCGGGATGGGCGTACC -> TGCACATCCGGGATGGGCGTACCC
GTTATATTTTCTCAAGCATGTTTG -> TTATATTTTCTCAAGCATGTTTGC
AGTGAAGGTCTGTACTAAGCGGGG -> GTGAAGGTCTGTACTAAGCGGGGC
AAGCGGGATTCAGTGCCAAGCCGT -> AGCGGGATTCAGTGCCAAGCCGTA
CTCGAAAGCTCACTGAAAGTTCTA -> TCGAAAGCTCACTGAAAGTTCTAT
GGAGGTGAGACAGGTACTCCTGTG -> GAGGTGAGACAGGTACTCCTGTGG
ACGTCCCAGGATAACCCATGCGTG -> CGTCCCAGGATAACCCATGCGTGA
GGGCGGCAAGCTTACAGTTACTCG -> GGCGGCAAGCTTACAGTTACTCGC
ACACCAGGACATAAGGAGGCCAGG -> CACCAGGACATAAGGAGGCCAGGT
TGCAAGGCTCCTTTCCGCCCATCC -> GCAAGGCTCCTTTCCGCCCATCCG
GGTAAAAGTAGGGTTGCGGTTAGG -> GTAAAAGTAGGGTTGCGGTTAGGC
AGCTTACAGTTACTCGCCTCTCTG -> GCTTACAGTTACTCGCCTCTCTGA
ATGTGCGGCAGTTCCTCATACACG -> TGTGCGGCAGTTCCTCATACACGT
AGGCTCACATATAGTTCGTACATA -> GGCTCACATATAGTTCGTACATAC
GAGTACGGTCCCTTTCGGATAGGG -> AGTACGGTCCCTTTCGGATAGGGG
CCATGCGTGATCCGAGCCGCAATC -> CATGCGTGATCCGAGCCGCAATCG
TGCATACACCACTTGGCAACAATG -> GCATACACCACTTGGCAACAATGT
GTTTTAGGGATGCTATCGCCGGGG -> TTTTAGGGATGCTATCGCCGGGGT
TACTCTCTGGGGTATGGCTACACG -> ACTCTCTGGGGTATGGCTACACGT
ATATGTACTAATTGCTCGTCGACT -> TATGTACTAATTGCTCGTCGACTA
GATAGGAGCCGCGTTGCTCAATAT -> ATAGGAGCCGCGTTGCTCAATATG
TCGGCTCGCTACTAAAGGGAGAGT -> CGGCTCGCTACTAAAGGGAGAGTG
TAAGCGGGATTCAGTGCCAAGCCG -> AAGCGGGATTCAGTGCCAAGCCGT
GCTCACATATAGTTCGTACATACT -> CTCACATATAGTTCGTACATACTT
ACACGTGTGTCCCGATCTGCAGCT -> CACGTGTGTCCCGATCTGCAGCTA
GTCGATTGAACGCTATCAAGCAGA -> TCGATTGAACGCTATCAAGCAGAT
TAGGGGCTTGGTATCCATAAACTC -> AGGGGCTTGGTATCCATAAACTCG
CGTTGCTCAATATGTACTAATTGC -> GTTGCTCAATATGTACTAATTGCT
AAGGTCTGTACTAAGCGGGGCCGT -> AGGTCTGTACTAAGCGGGGCCGTC
GCAAGCACATTGAGACTACACTCT -> CAAGCACATTGAGACTACACTCTA
AGGGAGGTGAGACAGGTACTCCTG -> GGGAGGTGAGACAGGTACTCCTGT
TCCCAGGATAACCCATGCGTGATC -> CCCAGGATAACCCATGCGTGATCC
GGATGCTATCGCCGGGGTTTGGTC -> GATGCTATCGCCGGGGTTTGGTCC
GGTTAGGCGTAATGGAGATCCTAA -> GTTAGGCGTAATGGAGATCCTAAG
AATCCATATCTTACTCAGTGTCGG -> ATCCATATCTTACTCAGTGTCGGC
TCTACGTCAGAGGCCGAGAGCTAC -> CTACGTCAGAGGCCGAGAGCTACC
TTCCACAACCTAGAAGCCGTAATT -> TCCACAACCTAGAAGCCGTAATTC
ACACCACTTGGCAACAATGTGACA -> CACCACTTGGCAACAATGTGACAC
GTACTAAGCGGGGCCGTCGACGGG -> TACTAAGCGGGGCCGTCGACGGGT
CAATGTATCCTCAGGCTACAGGAA -> AATGTATCCTCAGGCTACAGGAAT
TAATGGAGATCCTAAGCAATCCAT -> AATGGAGATCCTAAGCAATCCATA
GACCACGGATCACTCCATTATCCC -> ACCACGGATCACTCCATTATCCCA
CTTTCGGATAGGGGCTTGGTATCC -> TTTCGGATAGGGGCTTGGTATCCA
GACAGTCTGCAATGTATCCTCAGG -> ACAGTCTGCAATGTATCCTCAGGC
TTATCCTTAGTTTCCCTAGCCCAG -> TATCCTTAGTTTCCCTAGCCCAGC
GTCTATCAATCCTGCCCCGAGGTA -> TCTATCAATCCTGCCCCGAGGTAA
GCCGTGAGCAGATTACGAGGACGT -> CCGTGAGCAGATTACGAGGACGTC
CCGCTTTTTCTTCCGGGGACGGCT -> CGCTTTTTCTTCCGGGGACGGCTT
GTCCCTTTCGGATAGGGGCTTGGT -> TCCCTTTCGGATAGGGGCTTGGTA
GCAATAAATTAGTGTAACTAGTAA -> CAATAAATTAGTGTAACTAGTAAT
TGTTTCAGAACAGCCAACCTGCAT -> GTTTCAGAACAGCCAACCTGCATA
TGAGACTACACTCTAGCGTGTCTA -> GAGACTACACTCTAGCGTGTCTAC
AGCCGTAATTCAACAGTATGAGTC -> GCCGTAATTCAACAGTATGAGTCG
GTTTACAGGCTCACATATAGTTCG -> TTTACAGGCTCACATATAGTTCGT
TACACGTTTGTGACGCTAAATCAC -> ACACGTTTGTGACGCTAAATCACC
TGCCTTGCACCCGTGATAGCCGCG -> GCCTTGCACCCGTGATAGCCGCGG
TAGTGTCAAATTTATCGGCGTGCT -> AGTGTCAAATTTATCGGCGTGCTC
GAAAGTTCTATCCTAACCGTCGTG -> AAAGTTCTATCCTAACCGTCGTGC
GGTTATATTTTCTCAAGCATGTTT -> GTTATATTTTCTCAAGCATGTTTG
CGCTATCAAGCAGATTCGGGGCGG -> GCTATCAAGCAGATTCGGGGCGGT
GTTTGGTCCACGTGACGACCAGGT -> TTTGGTCCACGTGACGACCAGGTG
GGATTTCTGACTCGTTGCCGTGGT -> GATTTCTGACTCGTTGCCGTGGTG
AATGGAGATCCTAAGCAATCCATA -> ATGGAGATCCTAAGCAATCCATAT
CTTCTTGGACCTCGGTTCCGTACG -> TTCTTGGACCTCGGTTCCGTACGT
TGCGGTTAGGCGTAATGGAGATCC -> GCGGTTAGGCGTAATGGAGATCCT
GGCGAATGCACATCCGGGATGGGC -> GCGAATGCACATCCGGGATGGGCG
ACAGCCAACCTGCATACACCACTT -> CAGCCAACCTGCATACACCACTTG
CGGGTCTTCCGGGCAAGCACATTG -> GGGTCTTCCGGGCAAGCACATTGA
GCACACCAGGACATAAGGAGGCCA -> CACACCAGGACATAAGGAGGCCAG
CCGCCCATCCGCTGCCTTGCACCC -> CGCCCATCCGCTGCCTTGCACCCG
CTCGCCTCTCTGAGAAAGTCTCAA -> TCGCCTCTCTGAGAAAGTCTCAAC
ATAAGGAGGCCAGGTTGCCATGTG -> TAAGGAGGCCAGGTTGCCATGTGC
CGTACATACTTCAATTTTAGGAAA -> GTACATACTTCAATTTTAGGAAAC
GATAGTTATCATATGTCGGCTCGC -> ATAGTTATCATATGTCGGCTCGCT
CGTCCGTACAAGGTTCATAGTACG -> GTCCGTACAAGGTTCATAGTACGT
TCTCAACCCCCTGAGTTATTGGGG -> CTCAACCCCCTGAGTTATTGGGGC
TAAGTAGATAGGAGCCGCGTTGCT -> AAGTAGATAGGAGCCGCGTTGCTC
ATAGCCGCGGTACGTCCCAGGATA -> TAGCCGCGGTACGTCCCAGGATAA
TGGATAGTGTCAAATTTATCGGCG -> GGATAGTGTCAAATTTATCGGCGT
GATAGTTAACGCTGAGGGACCACG -> ATAGTTAACGCTGAGGGACCACGG
CTTGGTATCCATAAACTCGTGTTT -> TTGGTATCCATAAACTCGTGTTTC
ACGTACGAAAGATAGTTAACGCTG -> CGTACGAAAGATAGTTAACGCTGA
CGACTAAGTTCATCGCGGAATTGT -> GACTAAGTTCATCGCGGAATTGTA
AAGGAGGCCAGGTTGCCATGTGCG -> AGGAGGCCAGGTTGCCATGTGCGG
GCTCCTTTCCGCCCATCCGCTGCC -> CTCCTTTCCGCCCATCCGCTGCCT
TCGACGGGTCATGAGATCAGAAAC -> CGACGGGTCATGAGATCAGAAACG
TTCCACAAACGTGTACTCGACCTG -> TCCACAAACGTGTACTCGACCTGT
TAGGAGCCGCGTTGCTCAATATGT -> AGGAGCCGCGTTGCTCAATATGTA
TGGTATCCATAAACTCGTGTTTCA -> GGTATCCATAAACTCGTGTTTCAG
AGGTACTCCTGTGGGGCGGCAAGC -> GGTACTCCTGTGGGGCGGCAAGCT
CTACGTATTCCGCTAACTGAATGG -> TACGTATTCCGCTAACTGAATGGA
ACAACCTAGAAGCCGTAATTCAAC -> CAACCTAGAAGCCGTAATTCAACA
CTTAGTTTCCCTAGCCCAGCGCAA -> TTAGTTTCCCTAGCCCAGCGCAAC
AGCCAACCTGCATACACCACTTGG -> GCCAACCTGCATACACCACTTGGC
CATCATACGGTCCTCAGTATTATC -> ATCATACGGTCCTCAGTATTATCC
GGTATTTATGTTTATGAGTGAATG -> GTATTTATGTTTATGAGTGAATGA
TGTACTAAGCGGGGCCGTCGACGG -> GTACTAAGCGGGGCCGTCGACGGG
TTTCTGACTCGTTGCCGTGGTGTG -> TTCTGACTCGTTGCCGTGGTGTGG
CTCCCCGCCATGGAGGGCAAGCCC -> TCCCCGCCATGGAGGGCAAGCCCT
AGGTGCAAGGCTCCTTTCCGCCCA -> GGTGCAAGGCTCCTTTCCGCCCAT
TGCTCAATATGTACTAATTGCTCG -> GCTCAATATGTACTAATTGCTCGT
GTGCACACCAGGACATAAGGAGGC -> TGCACACCAGGACATAAGGAGGCC
GTTGATGCGGATTTCTGACTCGTT -> TTGATGCGGATTTCTGACTCGTTG
CACTTGGCAACAATGTGACACGTG -> ACTTGGCAACAATGTGACACGTGT
AGAAACGCGCCGTGAGCAGATTAC -> GAAACGCGCCGTGAGCAGATTACG
GATCGACGTTGCTCATTATCGAGG -> ATCGACGTTGCTCATTATCGAGGG
TTCATAGTACGTTTTTAAGCGGGA -> TCATAGTACGTTTTTAAGCGGGAT
ATGAATCTGTTCTTACTAAACTAC -> TGAATCTGTTCTTACTAAACTACT
GGGACGGCTTAAAGAGAATTCGAG -> GGACGGCTTAAAGAGAATTCGAGC
TTGATGCGGATTTCTGACTCGTTG -> TGATGCGGATTTCTGACTCGTTGC
GAAGCCGTAATTCAACAGTATGAG -> AAGCCGTAATTCAACAGTATGAGT
GATCCTAAGCAATCCATATCTTAC -> ATCCTAAGCAATCCATATCTTACT
GCAGATTCGGGGCGGTGCACACCA -> CAGATTCGGGGCGGTGCACACCAG
AAAGCTCACTGAAAGTTCTATCCT -> AAGCTCACTGAAAGTTCTATCCTA
ATAACCCATGCGTGATCCGAGCCG -> TAACCCATGCGTGATCCGAGCCGC
CCGTCGACGGGTCATGAGATCAGA -> CGTCGACGGGTCATGAGATCAGAA
GTCTGTACTAAGCGGGGCCGTCGA -> TCTGTACTAAGCGGGGCCGTCGAC
AGTTATGATAAGTAGATAGGAGCC -> GTTATGATAAGTAGATAGGAGCCG
CTGTACTAAGCGGGGCCGTCGACG -> TGTACTAAGCGGGGCCGTCGACGG
TTCTTGGACCTCGGTTCCGTACGT -> TCTTGGACCTCGGTTCCGTACGTT
GCGTGCTCCTCACGCGGAAGCTAC -> CGTGCTCCTCACGCGGAAGCTACG
CCCGATCTGCAGCTAGGAGGTATT -> CCGATCTGCAGCTAGGAGGTATTT
TGGACCTCGGTTCCGTACGTTCTC -> GGACCTCGGTTCCGTACGTTCTCG
CTCGACCTGTAGAGTACGGTCCCT -> TCGACCTGTAGAGTACGGTCCCTT
CCGTGATAGCCGCGGTACGTCCCA -> CGTGATAGCCGCGGTACGTCCCAG
GTCTACGTCAGAGGCCGAGAGCTA -> TCTACGTCAGAGGCCGAGAGCTAC
GCCGGGGTTTGGTCCACGTGACGA -> CCGGGGTTTGGTCCACGTGACGAC
GCCGCTAACAATTCGATAGTTATC -> CCGCTAACAATTCGATAGTTATCA
AGGGGCTTGGTATCCATAAACTCG -> GGGGCTTGGTATCCATAAACTCGT
TTACAGTTACTCGCCTCTCTGAGA -> TACAGTTACTCGCCTCTCTGAGAA
TGTGTATTATCAGGTGACTGGATG -> GTGTATTATCAGGTGACTGGATGG
ATCAGAAACGCGCCGTGAGCAGAT -> TCAGAAACGCGCCGTGAGCAGATT
GCCATTTGACGTACGAAAGATAGT -> CCATTTGACGTACGAAAGATAGTT
CTCTGCCATAGACTTATACCACAT -> TCTGCCATAGACTTATACCACATT
TGAGAAAGTCTCAACCCCCTGAGT -> GAGAAAGTCTCAACCCCCTGAGTT
CTGTAGAGTACGGTCCCTTTCGGA -> TGTAGAGTACGGTCCCTTTCGGAT
ATTGAGACTACACTCTAGCGTGTC -> TTGAGACTACACTCTAGCGTGTCT
GGGCGGTGCACACCAGGACATAAG -> GGCGGTGCACACCAGGACATAAGG
CGGGGACGGCTTAAAGAGAATTCG -> GGGGACGGCTTAAAGAGAATTCGA
AGCGGGGCCGTCGACGGGTCATGA -> GCGGGGCCGTCGACGGGTCATGAG
CTGAAAGTTCTATCCTAACCGTCG -> TGAAAGTTCTATCCTAACCGTCGT
AATTCGAGCAATAAATTAGTGTAA -> ATTCGAGCAATAAATTAGTGTAAC
GTTCGTACATACTTCAATTTTAGG -> TTCGTACATACTTCAATTTTAGGA
GGACCACGGATCACTCCATTATCC -> GACCACGGATCACTCCATTATCCC
CGTACGAAAGATAGTTAACGCTGA -> GTACGAAAGATAGTTAACGCTGAG
TACAGGCTCACATATAGTTCGTAC -> ACAGGCTCACATATAGTTCGTACA
ACCCTCCCCGCCATGGAGGGCAAG -> CCCTCCCCGCCATGGAGGGCAAGC
CCACAAACGTGTACTCGACCTGTA -> CACAAACGTGTACTCGACCTGTAG
AGTTCTATCCTAACCGTCGTGCAT -> GTTCTATCCTAACCGTCGTGCATG
CCATCCGCTGCCTTGCACCCGTGA -> CATCCGCTGCCTTGCACCCGTGAT
CCGCTAACAATTCGATAGTTATCA -> CGCTAACAATTCGATAGTTATCAT
ACGTGTGTCCCGATCTGCAGCTAG -> CGTGTGTCCCGATCTGCAGCTAGG
ATCGACGTTGCTCATTATCGAGGG -> TCGACGTTGCTCATTATCGAGGGC
TTGCTCAATATGTACTAATTGCTC -> TGCTCAATATGTACTAATTGCTCG
TCATACACGTAGCGCTCTGCCATA -> CATACACGTAGCGCTCTGCCATAG
TATTTTCTCAAGCATGTTTGCGCC -> ATTTTCTCAAGCATGTTTGCGCCG
ACCCATCTCCAGGAAGTGTTGCTG -> CCCATCTCCAGGAAGTGTTGCTGA
GATCCGAGCCGCAATCGCGGGTCT -> ATCCGAGCCGCAATCGCGGGTCTT
ACGAAAGATAGTTAACGCTGAGGG -> CGAAAGATAGTTAACGCTGAGGGA
AATGTATCCTCAGGCTACAGGAAT -> ATGTATCCTCAGGCTACAGGAATG
CACTCCATTATCCCAATGTTTGTG -> ACTCCATTATCCCAATGTTTGTGG
TACGTTTACAGGCTCACATATAGT -> ACGTTTACAGGCTCACATATAGTT
GCCGGCAGATTTCAGGAAAGAACC -> CCGGCAGATTTCAGGAAAGAACCA
CCTCACGCGGAAGCTACGTATTCC -> CTCACGCGGAAGCTACGTATTCCG
GCGTACCCCGTCCGTACAAGGTTC -> CGTACCCCGTCCGTACAAGGTTCA
GCTACGTATTCCGCTAACTGAATG -> CTACGTATTCCGCTAACTGAATGG
GGAAACCGTTTTAGGGATGCTATC -> GAAACCGTTTTAGGGATGCTATCG
ATCAAGCAGATTCGGGGCGGTGCA -> TCAAGCAGATTCGGGGCGGTGCAC
CCCATGCGTGATCCGAGCCGCAAT -> CCATGCGTGATCCGAGCCGCAATC
CTGCAATGTATCCTCAGGCTACAG -> TGCAATGTATCCTCAGGCTACAGG
AGTAGGGTTGCGGTTAGGCGTAAT -> GTAGGGTTGCGGTTAGGCGTAATG
GTGAGCAGATTACGAGGACGTCTT -> TGAGCAGATTACGAGGACGTCTTA
ATTCTGTCTATCAATCCTGCCCCG -> TTCTGTCTATCAATCCTGCCCCGA
CTCCTTTCCGCCCATCCGCTGCCT -> TCCTTTCCGCCCATCCGCTGCCTT
CGTGCTCCTCACGCGGAAGCTACG -> GTGCTCCTCACGCGGAAGCTACGT
GTATGGCTACACGTTTGTGACGCT -> TATGGCTACACGTTTGTGACGCTA
GCGGGGCCGTCGACGGGTCATGAG -> CGGGGCCGTCGACGGGTCATGAGA
ACATATAGTTCGTACATACTTCAA -> CATATAGTTCGTACATACTTCAAT
TTGCTCGTCGACTAAGTTCATCGC -> TGCTCGTCGACTAAGTTCATCGCG
GTCATGAGATCAGAAACGCGCCGT -> TCATGAGATCAGAAACGCGCCGTG
GGATAGGGGCTTGGTATCCATAAA -> GATAGGGGCTTGGTATCCATAAAC
AGTAATTTTCCACAACCTAGAAGC -> GTAATTTTCCACAACCTAGAAGCC
CTATCAATCCTGCCCCGAGGTAAC -> TATCAATCCTGCCCCGAGGTAACT
GCTAAATCACCCGTGGATAGTGTC -> CTAAATCACCCGTGGATAGTGTCA
ATGTTTGTGGTAAAAGTAGGGTTG -> TGTTTGTGGTAAAAGTAGGGTTGC
GCTAACAATTCGATAGTTATCATA -> CTAACAATTCGATAGTTATCATAT
CCTGCATACACCACTTGGCAACAA -> CTGCATACACCACTTGGCAACAAT
CGGGATTCAGTGCCAAGCCGTAGT -> GGGATTCAGTGCCAAGCCGTAGTA
TACACTCTAGCGTGTCTACGTCAG -> ACACTCTAGCGTGTCTACGTCAGA
ACACCAAGACACTTGTGGCGACGA -> CACCAAGACACTTGTGGCGACGAG
CAGACAGTCTGCAATGTATCCTCA -> AGACAGTCTGCAATGTATCCTCAG
ACCGCTTTTTCTTCCGGGGACGGC -> CCGCTTTTTCTTCCGGGGACGGCT
GCAAGGCTCCTTTCCGCCCATCCG -> CAAGGCTCCTTTCCGCCCATCCGC
ATACACCACTTGGCAACAATGTGA -> TACACCACTTGGCAACAATGTGAC
GACTACACTCTAGCGTGTCTACGT -> ACTACACTCTAGCGTGTCTACGTC
ATGGCCTTCCACAAACGTGTACTC -> TGGCCTTCCACAAACGTGTACTCG
ATACGTTTACAGGCTCACATATAG -> TACGTTTACAGGCTCACATATAGT
AGAGTGAAGGTCTGTACTAAGCGG -> GAGTGAAGGTCTGTACTAAGCGGG
GTACGTTTTTAAGCGGGATTCAGT -> TACGTTTTTAAGCGGGATTCAGTG
GCATGTTTGCGCCGGCAGATTTCA -> CATGTTTGCGCCGGCAGATTTCAG
TGTATTATCAGGTGACTGGATGGC -> GTATTATCAGGTGACTGGATGGCG
GTTTGTGGTAAAAGTAGGGTTGCG -> TTTGTGGTAAAAGTAGGGTTGCGG
CGCTACTAAAGGGAGAGTGAAGGT -> GCTACTAAAGGGAGAGTGAAGGTC
TCTAGCGTGTCTACGTCAGAGGCC -> CTAGCGTGTCTACGTCAGAGGCCG
ACAGGCTCACATATAGTTCGTACA -> CAGGCTCACATATAGTTCGTACAT
TCACTGAAAGTTCTATCCTAACCG -> CACTGAAAGTTCTATCCTAACCGT
GGCAAGCCCTCACCGCTTTTTCTT -> GCAAGCCCTCACCGCTTTTTCTTC
GGCCCGATCATTTTATCGATTTTA -> GCCCGATCATTTTATCGATTTTAG
TTTATCGGCGTGCTCCTCACGCGG -> TTATCGGCGTGCTCCTCACGCGGA
GAGGACGTCTTAGTTGAATACGTT -> AGGACGTCTTAGTTGAATACGTTT
AAAGATAGTTAACGCTGAGGGACC -> AAGATAGTTAACGCTGAGGGACCA
TGCCCCGAGGTAACTTCTTGGACC -> GCCCCGAGGTAACTTCTTGGACCT
GTTTATGAGTGAATGAACCCATCT -> TTTATGAGTGAATGAACCCATCTC
CTCTAGCGTGTCTACGTCAGAGGC -> TCTAGCGTGTCTACGTCAGAGGCC
TATGTCGGCTCGCTACTAAAGGGA -> ATGTCGGCTCGCTACTAAAGGGAG
ATTTATGTTTATGAGTGAATGAAC -> TTTATGTTTATGAGTGAATGAACC
GACCTGTAGAGTACGGTCCCTTTC -> ACCTGTAGAGTACGGTCCCTTTCG
TTGTATTGGAAGCCGCTAACAATT -> TGTATTGGAAGCCGCTAACAATTC
TCTCTGAGAAAGTCTCAACCCCCT -> CTCTGAGAAAGTCTCAACCCCCTG
CACCAAGACACTTGTGGCGACGAG -> ACCAAGACACTTGTGGCGACGAGG
CTTCCACAAACGTGTACTCGACCT -> TTCCACAAACGTGTACTCGACCTG
CGACGTTGCTCATTATCGAGGGCC -> GACGTTGCTCATTATCGAGGGCCT
AGCAATCCATATCTTACTCAGTGT -> GCAATCCATATCTTACTCAGTGTC
GTTCTTACTAAACTACTGTCTTGA -> TTCTTACTAAACTACTGTCTTGAC
TGCGTGATCCGAGCCGCAATCGCG -> GCGTGATCCGAGCCGCAATCGCGG
CAATTTTAGGAAACCGTTTTAGGG -> AATTTTAGGAAACCGTTTTAGGGA
TGAGTGAATGAACCCATCTCCAGG -> GAGTGAATGAACCCATCTCCAGGA
AAGAACCATCATACGGTCCTCAGT -> AGAACCATCATACGGTCCTCAGTA
TCACCCGTGGATAGTGTCAAATTT -> CACCCGTGGATAGTGTCAAATTTA
CGGGGCGGTGCACACCAGGACATA -> GGGGCGGTGCACACCAGGACATAA
CCCAGGATAACCCATGCGTGATCC -> CCAGGATAACCCATGCGTGATCCG
AAGGGAGAGTGAAGGTCTGTACTA -> AGGGAGAGTGAAGGTCTGTACTAA
GAGCTACCCTCCCCGCCATGGAGG -> AGCTACCCTCCCCGCCATGGAGGG
CGGCGTGCTCCTCACGCGGAAGCT -> GGCGTGCTCCTCACGCGGAAGCTA
TTGACGTACGAAAGATAGTTAACG -> TGACGTACGAAAGATAGTTAACGC
AGTGAATGAACCCATCTCCAGGAA -> GTGAATGAACCCATCTCCAGGAAG
CTGCAGCTAGGAGGTATTTATGTT -> TGCAGCTAGGAGGTATTTATGTTT
AGCTACGTATTCCGCTAACTGAAT -> GCTACGTATTCCGCTAACTGAATG
GCAGTTCCTCATACACGTAGCGCT -> CAGTTCCTCATACACGTAGCGCTC
GTGGGGCGGCAAGCTTACAGTTAC -> TGGGGCGGCAAGCTTACAGTTACT
CCCATCCGCTGCCTTGCACCCGTG -> CCATCCGCTGCCTTGCACCCGTGA
TAACCCATGCGTGATCCGAGCCGC -> AACCCATGCGTGATCCGAGCCGCA
GCTAGGAGGTATTTATGTTTATGA -> CTAGGAGGTATTTATGTTTATGAG
TGAATGGATCGACGTTGCTCATTA -> GAATGGATCGACGTTGCTCATTAT
CGGATTTCTGACTCGTTGCCGTGG -> GGATTTCTGACTCGTTGCCGTGGT
CAGGTTATATTTTCTCAAGCATGT -> AGGTTATATTTTCTCAAGCATGTT
AAACTACTGTCTTGACTCCTCAGA -> AACTACTGTCTTGACTCCTCAGAT
CGCAACAGTTAGGACACAACACCA -> GCAACAGTTAGGACACAACACCAA
TCTCGAAAGCTCACTGAAAGTTCT -> CTCGAAAGCTCACTGAAAGTTCTA
AACCCATCTCCAGGAAGTGTTGCT -> ACCCATCTCCAGGAAGTGTTGCTG
CCTTCCACAAACGTGTACTCGACC -> CTTCCACAAACGTGTACTCGACCT
GAGCCGCAATCGCGGGTCTTCCGG -> AGCCGCAATCGCGGGTCTTCCGGG
TTTTAGGGATGCTATCGCCGGGGT -> TTTAGGGATGCTATCGCCGGGGTT
CTGCCCCGAGGTAACTTCTTGGAC -> TGCCCCGAGGTAACTTCTTGGACC
ACCAGGACATAAGGAGGCCAGGTT -> CCAGGACATAAGGAGGCCAGGTTG
TGTTCTTACTAAACTACTGTCTTG -> GTTCTTACTAAACTACTGTCTTGA
TTGCCATGTGCGGCAGTTCCTCAT -> TGCCATGTGCGGCAGTTCCTCATA
TAGCCCAGCGCAACAGTTAGGACA -> AGCCCAGCGCAACAGTTAGGACAC
GTCGGCCCGATCATTTTATCGATT -> TCGGCCCGATCATTTTATCGATTT
TCGCCTCTCTGAGAAAGTCTCAAC -> CGCCTCTCTGAGAAAGTCTCAACC
ATGGGCGTACCCCGTCCGTACAAG -> TGGGCGTACCCCGTCCGTACAAGG
TCTGCCATAGACTTATACCACATT -> CTGCCATAGACTTATACCACATTT
ATCACACAGGTTATATTTTCTCAA -> TCACACAGGTTATATTTTCTCAAG
TGTCCCGATCTGCAGCTAGGAGGT -> GTCCCGATCTGCAGCTAGGAGGTA
ATTTGACGTACGAAAGATAGTTAA -> TTTGACGTACGAAAGATAGTTAAC
CTCAGATTCTGTCTATCAATCCTG -> TCAGATTCTGTCTATCAATCCTGC
TCGATTGAACGCTATCAAGCAGAT -> CGATTGAACGCTATCAAGCAGATT
TTCGAGCAATAAATTAGTGTAACT -> TCGAGCAATAAATTAGTGTAACTA
TGCGGCAGTTCCTCATACACGTAG -> GCGGCAGTTCCTCATACACGTAGC
TACGAAAGATAGTTAACGCTGAGG -> ACGAAAGATAGTTAACGCTGAGGG
AAAGTCTCAACCCCCTGAGTTATT -> AAGTCTCAACCCCCTGAGTTATTG
GAAAGCTCACTGAAAGTTCTATCC -> AAAGCTCACTGAAAGTTCTATCCT
GCGTAATGGAGATCCTAAGCAATC -> CGTAATGGAGATCCTAAGCAATCC
TAGGCCATTTGACGTACGAAAGAT -> AGGCCATTTGACGTACGAAAGATA
TTACTAAACTACTGTCTTGACTCC -> TACTAAACTACTGTCTTGACTCCT
GGAGATCCTAAGCAATCCATATCT -> GAGATCCTAAGCAATCCATATCTT
TATCGAGGGCCTATATATTAAATT -> ATCGAGGGCCTATATATTAAATTA
TTTGTGGTAAAAGTAGGGTTGCGG -> TTGTGGTAAAAGTAGGGTTGCGGT
ACTCGTTGCCGTGGTGTGGCGAAT -> CTCGTTGCCGTGGTGTGGCGAATG
TATCAATCCTGCCCCGAGGTAACT -> ATCAATCCTGCCCCGAGGTAACTT
CTCGTGTTTCAGAACAGCCAACCT -> TCGTGTTTCAGAACAGCCAACCTG
CAAGCACATTGAGACTACACTCTA -> AAGCACATTGAGACTACACTCTAG
ACCTGTAGAGTACGGTCCCTTTCG -> CCTGTAGAGTACGGTCCCTTTCGG
TTTAGGGATGCTATCGCCGGGGTT -> TTAGGGATGCTATCGCCGGGGTTT
CCGTACGTTCTCGAAAGCTCACTG -> CGTACGTTCTCGAAAGCTCACTGA
GCTGAGGGACCACGGATCACTCCA -> CTGAGGGACCACGGATCACTCCAT
CATCTCCAGGAAGTGTTGCTGACC -> ATCTCCAGGAAGTGTTGCTGACCC
CGCGTTGCTCAATATGTACTAATT -> GCGTTGCTCAATATGTACTAATTG
CTCCTCACGCGGAAGCTACGTATT -> TCCTCACGCGGAAGCTACGTATTC
CAAGGTTCATAGTACGTTTTTAAG -> AAGGTTCATAGTACGTTTTTAAGC
GGCGGCAAGCTTACAGTTACTCGC -> GCGGCAAGCTTACAGTTACTCGCC
TGGTGTGGCGAATGCACATCCGGG -> GGTGTGGCGAATGCACATCCGGGA
CCAGGTTGCCATGTGCGGCAGTTC -> CAGGTTGCCATGTGCGGCAGTTCC
AGTGTTGCTGACCCGTCTTGAGGC -> GTGTTGCTGACCCGTCTTGAGGCC
TCAAATTTATCGGCGTGCTCCTCA -> CAAATTTATCGGCGTGCTCCTCAC
TAACTGAATGGATCGACGTTGCTC -> AACTGAATGGATCGACGTTGCTCA
GGGTCTTCCGGGCAAGCACATTGA -> GGTCTTCCGGGCAAGCACATTGAG
GCCATAGACTTATACCACATTTGT -> CCATAGACTTATACCACATTTGTT
CGGGTCATGAGATCAGAAACGCGC -> GGGTCATGAGATCAGAAACGCGCC
GTCGCCATTGTATTGGAAGCCGCT -> TCGCCATTGTATTGGAAGCCGCTA
GAAACCGTTTTAGGGATGCTATCG -> AAACCGTTTTAGGGATGCTATCGC
ATGGCGTAGGCCATTTGACGTACG -> TGGCGTAGGCCATTTGACGTACGA
CGTTTTTAAGCGGGATTCAGTGCC -> GTTTTTAAGCGGGATTCAGTGCCA
TAGGACACAACACCAAGACACTTG -> AGGACACAACACCAAGACACTTGT
CAAACGTGTACTCGACCTGTAGAG -> AAACGTGTACTCGACCTGTAGAGT
GTCTTAGTTGAATACGTTTACAGG -> TCTTAGTTGAATACGTTTACAGGC
AATTTTAGGAAACCGTTTTAGGGA -> ATTTTAGGAAACCGTTTTAGGGAT
AAGAGAATTCGAGCAATAAATTAG -> AGAGAATTCGAGCAATAAATTAGT
CTCTCTGAGAAAGTCTCAACCCCC -> TCTCTGAGAAAGTCTCAACCCCCT
CACGTTTGTGACGCTAAATCACCC -> ACGTTTGTGACGCTAAATCACCCG
TGCTATCGCCGGGGTTTGGTCCAC -> GCTATCGCCGGGGTTTGGTCCACG
GTCAAATTTATCGGCGTGCTCCTC -> TCAAATTTATCGGCGTGCTCCTCA
GTACCCCGTCCGTACAAGGTTCAT -> TACCCCGTCCGTACAAGGTTCATA
GTTGCTCAATATGTACTAATTGCT -> TTGCTCAATATGTACTAATTGCTC
AGGAAACCGTTTTAGGGATGCTAT -> GGAAACCGTTTTAGGGATGCTATC
AGTTCATCGCGGAATTGTACTCTC -> GTTCATCGCGGAATTGTACTCTCT
TTCCGTACGTTCTCGAAAGCTCAC -> TCCGTACGTTCTCGAAAGCTCACT
ACTCGCCTCTCTGAGAAAGTCTCA -> CTCGCCTCTCTGAGAAAGTCTCAA
TAGTTGAATACGTTTACAGGCTCA -> AGTTGAATACGTTTACAGGCTCAC
TGCAATGTATCCTCAGGCTACAGG -> GCAATGTATCCTCAGGCTACAGGA
CCGTAATTCAACAGTATGAGTCGA -> CGTAATTCAACAGTATGAGTCGAT
CATTATCGAGGGCCTATATATTAA -> ATTATCGAGGGCCTATATATTAAA
GAGACAGGTACTCCTGTGGGGCGG -> AGACAGGTACTCCTGTGGGGCGGC
TAACTAGTAATTTTCCACAACCTA -> AACTAGTAATTTTCCACAACCTAG
CTTACAGTTACTCGCCTCTCTGAG -> TTACAGTTACTCGCCTCTCTGAGA
TCGGATAGGGGCTTGGTATCCATA -> CGGATAGGGGCTTGGTATCCATAA
TATTGGAAGCCGCTAACAATTCGA -> ATTGGAAGCCGCTAACAATTCGAT
AGGTTATATTTTCTCAAGCATGTT -> GGTTATATTTTCTCAAGCATGTTT
TAATTGCTCGTCGACTAAGTTCAT -> AATTGCTCGTCGACTAAGTTCATC
GGAGGGCAAGCCCTCACCGCTTTT -> GAGGGCAAGCCCTCACCGCTTTTT
TAAGGAGGCCAGGTTGCCATGTGC -> AAGGAGGCCAGGTTGCCATGTGCG
GGATGGCGTAGGCCATTTGACGTA -> GATGGCGTAGGCCATTTGACGTAC
TGAAGGTCTGTACTAAGCGGGGCC -> GAAGGTCTGTACTAAGCGGGGCCG
AGGTAACTTCTTGGACCTCGGTTC -> GGTAACTTCTTGGACCTCGGTTCC
GGCGGTCGCCATTGTATTGGAAGC -> GCGGTCGCCATTGTATTGGAAGCC
GTTTGCGCCGGCAGATTTCAGGAA -> TTTGCGCCGGCAGATTTCAGGAAA
GTCTTGACTCCTCAGATTCTGTCT -> TCTTGACTCCTCAGATTCTGTCTA
CTTTTTCTTCCGGGGACGGCTTAA -> TTTTTCTTCCGGGGACGGCTTAAA
TACATACTTCAATTTTAGGAAACC -> ACATACTTCAATTTTAGGAAACCG
CACTCTAGCGTGTCTACGTCAGAG -> ACTCTAGCGTGTCTACGTCAGAGG
AGTTCCTCATACACGTAGCGCTCT -> GTTCCTCATACACGTAGCGCTCTG
TCATTTTATCGATTTTAGATCACA -> CATTTTATCGATTTTAGATCACAC
CCACAACCTAGAAGCCGTAATTCA -> CACAACCTAGAAGCCGTAATTCAA
TTAAGCGGGATTCAGTGCCAAGCC -> TAAGCGGGATTCAGTGCCAAGCCG
GCACATTGAGACTACACTCTAGCG -> CACATTGAGACTACACTCTAGCGT
CGCCATTGTATTGGAAGCCGCTAA -> GCCATTGTATTGGAAGCCGCTAAC
GATTCTGTCTATCAATCCTGCCCC -> ATTCTGTCTATCAATCCTGCCCCG
GTTAGGCGTAATGGAGATCCTAAG -> TTAGGCGTAATGGAGATCCTAAGC
TGAGCAGATTACGAGGACGTCTTA -> GAGCAGATTACGAGGACGTCTTAG
ATCACCCGTGGATAGTGTCAAATT -> TCACCCGTGGATAGTGTCAAATTT
TCCAGGAAGTGTTGCTGACCCGTC -> CCAGGAAGTGTTGCTGACCCGTCT
ACGTCTTAGTTGAATACGTTTACA -> CGTCTTAGTTGAATACGTTTACAG
ATGTATCCTCAGGCTACAGGAATG -> TGTATCCTCAGGCTACAGGAATGA
TACACCACTTGGCAACAATGTGAC -> ACACCACTTGGCAACAATGTGACA
TTAGGACACAACACCAAGACACTT -> TAGGACACAACACCAAGACACTTG
CCCCGCCATGGAGGGCAAGCCCTC -> CCCGCCATGGAGGGCAAGCCCTCA
GTTGCCGTGGTGTGGCGAATGCAC -> TTGCCGTGGTGTGGCGAATGCACA
GACCCGTCTTGAGGCCTTGACTCA -> ACCCGTCTTGAGGCCTTGACTCAG
ATCATATGTCGGCTCGCTACTAAA -> TCATATGTCGGCTCGCTACTAAAG
ATCCGAGCCGCAATCGCGGGTCTT -> TCCGAGCCGCAATCGCGGGTCTTC
GGCCATTTGACGTACGAAAGATAG -> GCCATTTGACGTACGAAAGATAGT
CGTCGTGCATGGCCTTCCACAAAC -> GTCGTGCATGGCCTTCCACAAACG
ATTTTATCGATTTTAGATCACACA -> TTTTATCGATTTTAGATCACACAG
CTAGCGTGTCTACGTCAGAGGCCG -> TAGCGTGTCTACGTCAGAGGCCGA
GGGGCGGTGCACACCAGGACATAA -> GGGCGGTGCACACCAGGACATAAG
AGTTACTCGCCTCTCTGAGAAAGT -> GTTACTCGCCTCTCTGAGAAAGTC
ACTAAGTTCATCGCGGAATTGTAC -> CTAAGTTCATCGCGGAATTGTACT
TGTCTACGTCAGAGGCCGAGAGCT -> GTCTACGTCAGAGGCCGAGAGCTA
CCCGTCCGTACAAGGTTCATAGTA -> CCGTCCGTACAAGGTTCATAGTAC
TATCGATTTTAGATCACACAGGTT -> ATCGATTTTAGATCACACAGGTTA
GGGGCTTGGTATCCATAAACTCGT -> GGGCTTGGTATCCATAAACTCGTG
AACTAGTAATTTTCCACAACCTAG -> ACTAGTAATTTTCCACAACCTAGA
TTTTAGATCACACAGGTTATATTT -> TTTAGATCACACAGGTTATATTTT
TCGACCTGTAGAGTACGGTCCCTT -> CGACCTGTAGAGTACGGTCCCTTT
TCGCTACTAAAGGGAGAGTGAAGG -> CGCTACTAAAGGGAGAGTGAAGGT
ACTAAAGGGAGAGTGAAGGTCTGT -> CTAAAGGGAGAGTGAAGGTCTGTA
TTGAGACTACACTCTAGCGTGTCT -> TGAGACTACACTCTAGCGTGTCTA
GGAGTTATGATAAGTAGATAGGAG -> GAGTTATGATAAGTAGATAGGAGC
AATGAATCTGTTCTTACTAAACTA -> ATGAATCTGTTCTTACTAAACTAC
TTAGTGTAACTAGTAATTTTCCAC -> TAGTGTAACTAGTAATTTTCCACA
ACACTTGTGGCGACGAGGGAGGTG -> CACTTGTGGCGACGAGGGAGGTGA
ACGAGGGAGGTGAGACAGGTACTC -> CGAGGGAGGTGAGACAGGTACTCC
ACGACCAGGTGCAAGGCTCCTTTC -> CGACCAGGTGCAAGGCTCCTTTCC
TACTCGACCTGTAGAGTACGGTCC -> ACTCGACCTGTAGAGTACGGTCCC
GAGGGAGGTGAGACAGGTACTCCT -> AGGGAGGTGAGACAGGTACTCCTG
TTTTAGGAAACCGTTTTAGGGATG -> TTTAGGAAACCGTTTTAGGGATGC
GAGTGAATGAACCCATCTCCAGGA -> AGTGAATGAACCCATCTCCAGGAA
CAACCTGCATACACCACTTGGCAA -> AACCTGCATACACCACTTGGCAAC
TACAAGGTTCATAGTACGTTTTTA -> ACAAGGTTCATAGTACGTTTTTAA
CTCTGGGGTATGGCTACACGTTTG -> TCTGGGGTATGGCTACACGTTTGT
ACGCGCCGTGAGCAGATTACGAGG -> CGCGCCGTGAGCAGATTACGAGGA
CACGTGTGTCCCGATCTGCAGCTA -> ACGTGTGTCCCGATCTGCAGCTAG
TCCCGATCTGCAGCTAGGAGGTAT -> CCCGATCTGCAGCTAGGAGGTATT
ATTATCCCAATGTTTGTGGTAAAA -> TTATCCCAATGTTTGTGGTAAAAG
AGGCCATTTGACGTACGAAAGATA -> GGCCATTTGACGTACGAAAGATAG
TACGTATTCCGCTAACTGAATGGA -> ACGTATTCCGCTAACTGAATGGAT
GCCATGTGCGGCAGTTCCTCATAC -> CCATGTGCGGCAGTTCCTCATACA
AGTCTCAACCCCCTGAGTTATTGG -> GTCTCAACCCCCTGAGTTATTGGG
GATAAGTAGATAGGAGCCGCGTTG -> ATAAGTAGATAGGAGCCGCGTTGC
GATTTCAGGAAAGAACCATCATAC -> ATTTCAGGAAAGAACCATCATACG
GGCTATGGCGGTCGCCATTGTATT -> GCTATGGCGGTCGCCATTGTATTG
CCGTACAAGGTTCATAGTACGTTT -> CGTACAAGGTTCATAGTACGTTTT
TCTATCAATCCTGCCCCGAGGTAA -> CTATCAATCCTGCCCCGAGGTAAC
GTCCCGATCTGCAGCTAGGAGGTA -> TCCCGATCTGCAGCTAGGAGGTAT
AGGCCGAGAGCTACCCTCCCCGCC -> GGCCGAGAGCTACCCTCCCCGCCA
CGGAAGCTACGTATTCCGCTAACT -> GGAAGCTACGTATTCCGCTAACTG
ACTCCTGTGGGGCGGCAAGCTTAC -> CTCCTGTGGGGCGGCAAGCTTACA
TCGTTGCCGTGGTGTGGCGAATGC -> CGTTGCCGTGGTGTGGCGAATGCA
ATCCTCAGGCTACAGGAATGAATC -> TCCTCAGGCTACAGGAATGAATCT
TTTAGATCACACAGGTTATATTTT -> TTAGATCACACAGGTTATATTTTC
ATGTCGGCTCGCTACTAAAGGGAG -> TGTCGGCTCGCTACTAAAGGGAGA
GAATTCGAGCAATAAATTAGTGTA -> AATTCGAGCAATAAATTAGTGTAA
GTGTACTCGACCTGTAGAGTACGG -> TGTACTCGACCTGTAGAGTACGGT
GTACATACTTCAATTTTAGGAAAC -> TACATACTTCAATTTTAGGAAACC
GCGCAACAGTTAGGACACAACACC -> CGCAACAGTTAGGACACAACACCA
GTGTAACTAGTAATTTTCCACAAC -> TGTAACTAGTAATTTTCCACAACC
AGGAAAGAACCATCATACGGTCCT -> GGAAAGAACCATCATACGGTCCTC
TCCACAAACGTGTACTCGACCTGT -> CCACAAACGTGTACTCGACCTGTA
GTGGTAAAAGTAGGGTTGCGGTTA -> TGGTAAAAGTAGGGTTGCGGTTAG
CAGCGCAACAGTTAGGACACAACA -> AGCGCAACAGTTAGGACACAACAC
AGTCGATTGAACGCTATCAAGCAG -> GTCGATTGAACGCTATCAAGCAGA
CACAAACGTGTACTCGACCTGTAG -> ACAAACGTGTACTCGACCTGTAGA
TATGAGTGAATGAACCCATCTCCA -> ATGAGTGAATGAACCCATCTCCAG
ACTACACTCTAGCGTGTCTACGTC -> CTACACTCTAGCGTGTCTACGTCA
TAGTTCGTACATACTTCAATTTTA -> AGTTCGTACATACTTCAATTTTAG
CGTGACGACCAGGTGCAAGGCTCC -> GTGACGACCAGGTGCAAGGCTCCT
GCTCCTCACGCGGAAGCTACGTAT -> CTCCTCACGCGGAAGCTACGTATT
ACTCAGGTTGATGCGGATTTCTGA -> CTCAGGTTGATGCGGATTTCTGAC
GCGGGATTCAGTGCCAAGCCGTAG -> CGGGATTCAGTGCCAAGCCGTAGT
ATGTTTGCGCCGGCAGATTTCAGG -> TGTTTGCGCCGGCAGATTTCAGGA
GATGGCGTAGGCCATTTGACGTAC -> ATGGCGTAGGCCATTTGACGTACG
TTTATCGATTTTAGATCACACAGG -> TTATCGATTTTAGATCACACAGGT
AGTTATTGGGGCTATGGCGGTCGC -> GTTATTGGGGCTATGGCGGTCGCC
TCATATGTCGGCTCGCTACTAAAG -> CATATGTCGGCTCGCTACTAAAGG
TGTTGCTGACCCGTCTTGAGGCCT -> GTTGCTGACCCGTCTTGAGGCCTT
GTTATCATATGTCGGCTCGCTACT -> TTATCATATGTCGGCTCGCTACTA
ACAGGAATGAATCTGTTCTTACTA -> CAGGAATGAATCTGTTCTTACTAA
CTGAGGGACCACGGATCACTCCAT -> TGAGGGACCACGGATCACTCCATT
AAGCTTACAGTTACTCGCCTCTCT -> AGCTTACAGTTACTCGCCTCTCTG
GTCCACGTGACGACCAGGTGCAAG -> TCCACGTGACGACCAGGTGCAAGG
GCAATCGCGGGTCTTCCGGGCAAG -> CAATCGCGGGTCTTCCGGGCAAGC
CACCCGTGATAGCCGCGGTACGTC -> ACCCGTGATAGCCGCGGTACGTCC
TGACTCAGGTTGATGCGGATTTCT -> GACTCAGGTTGATGCGGATTTCTG
CGTAATGGAGATCCTAAGCAATCC -> GTAATGGAGATCCTAAGCAATCCA
GGGCCGTCGACGGGTCATGAGATC -> GGCCGTCGACGGGTCATGAGATCA
AAGCATGTTTGCGCCGGCAGATTT -> AGCATGTTTGCGCCGGCAGATTTC
TGTCGGCCCGATCATTTTATCGAT -> GTCGGCCCGATCATTTTATCGATT
AAACGTGTACTCGACCTGTAGAGT -> AACGTGTACTCGACCTGTAGAGTA
TTCCCTAGCCCAGCGCAACAGTTA -> TCCCTAGCCCAGCGCAACAGTTAG
CTGTCTATCAATCCTGCCCCGAGG -> TGTCTATCAATCCTGCCCCGAGGT
GTTATGATAAGTAGATAGGAGCCG -> TTATGATAAGTAGATAGGAGCCGC
AGAAGCCGTAATTCAACAGTATGA -> GAAGCCGTAATTCAACAGTATGAG
GGATAACCCATGCGTGATCCGAGC -> GATAACCCATGCGTGATCCGAGCC
TTTAAGCGGGATTCAGTGCCAAGC -> TTAAGCGGGATTCAGTGCCAAGCC
AGCTCACTGAAAGTTCTATCCTAA -> GCTCACTGAAAGTTCTATCCTAAC
TACGGTCCTCAGTATTATCCTTAG -> ACGGTCCTCAGTATTATCCTTAGT
GGTATGGCTACACGTTTGTGACGC -> GTATGGCTACACGTTTGTGACGCT
CGTGGTGTGGCGAATGCACATCCG -> GTGGTGTGGCGAATGCACATCCGG
GTTAGGACACAACACCAAGACACT -> TTAGGACACAACACCAAGACACTT
GGAGGCCAGGTTGCCATGTGCGGC -> GAGGCCAGGTTGCCATGTGCGGCA
ATAAATTAGTGTAACTAGTAATTT -> TAAATTAGTGTAACTAGTAATTTT
ACGTTTTTAAGCGGGATTCAGTGC -> CGTTTTTAAGCGGGATTCAGTGCC
TATCCCAATGTTTGTGGTAAAAGT -> ATCCCAATGTTTGTGGTAAAAGTA
CACACCAGGACATAAGGAGGCCAG -> ACACCAGGACATAAGGAGGCCAGG
TGTGCGGCAGTTCCTCATACACGT -> GTGCGGCAGTTCCTCATACACGTA
CATAGTACGTTTTTAAGCGGGATT -> ATAGTACGTTTTTAAGCGGGATTC
GATTCAGTGCCAAGCCGTAGTAGG -> ATTCAGTGCCAAGCCGTAGTAGGT
GAGTCGATTGAACGCTATCAAGCA -> AGTCGATTGAACGCTATCAAGCAG
ACCACTTGGCAACAATGTGACACG -> CCACTTGGCAACAATGTGACACGT
GTACGTCCCAGGATAACCCATGCG -> TACGTCCCAGGATAACCCATGCGT
CAAGCCGTAGTAGGTGTGTATTAT -> AAGCCGTAGTAGGTGTGTATTATC
ATACCACATTTGTTGGAGTTATGA -> TACCACATTTGTTGGAGTTATGAT
CTCACATATAGTTCGTACATACTT -> TCACATATAGTTCGTACATACTTC
CTGGGGTATGGCTACACGTTTGTG -> TGGGGTATGGCTACACGTTTGTGA
GTGAATGAACCCATCTCCAGGAAG -> TGAATGAACCCATCTCCAGGAAGT
GTGCCAAGCCGTAGTAGGTGTGTA -> TGCCAAGCCGTAGTAGGTGTGTAT
ACACAACACCAAGACACTTGTGGC -> CACAACACCAAGACACTTGTGGCG
ACACAGGTTATATTTTCTCAAGCA -> CACAGGTTATATTTTCTCAAGCAT
CTGACCCGTCTTGAGGCCTTGACT -> TGACCCGTCTTGAGGCCTTGACTC
TCCGTACAAGGTTCATAGTACGTT -> CCGTACAAGGTTCATAGTACGTTT
TCCTCAGTATTATCCTTAGTTTCC -> CCTCAGTATTATCCTTAGTTTCCC
TGATGCGGATTTCTGACTCGTTGC -> GATGCGGATTTCTGACTCGTTGCC
GGTAACTTCTTGGACCTCGGTTCC -> GTAACTTCTTGGACCTCGGTTCCG
CAATGTTTGTGGTAAAAGTAGGGT -> AATGTTTGTGGTAAAAGTAGGGTT
CTCAGTATTATCCTTAGTTTCCCT -> TCAGTATTATCCTTAGTTTCCCTA
CCGTCTTGAGGCCTTGACTCAGGT -> CGTCTTGAGGCCTTGACTCAGGTT
AAACTCGTGTTTCAGAACAGCCAA -> AACTCGTGTTTCAGAACAGCCAAC
GAAGTGTTGCTGACCCGTCTTGAG -> AAGTGTTGCTGACCCGTCTTGAGG
TTGCTGACCCGTCTTGAGGCCTTG -> TGCTGACCCGTCTTGAGGCCTTGA
AATGTGACACGTGTGTCCCGATCT -> ATGTGACACGTGTGTCCCGATCTG
AATTAGTGTAACTAGTAATTTTCC -> ATTAGTGTAACTAGTAATTTTCCA
GGAGCCGCGTTGCTCAATATGTAC -> GAGCCGCGTTGCTCAATATGTACT
ACCCGTGATAGCCGCGGTACGTCC -> CCCGTGATAGCCGCGGTACGTCCC
GCGGAATTGTACTCTCTGGGGTAT -> CGGAATTGTACTCTCTGGGGTATG
TATTCCGCTAACTGAATGGATCGA -> ATTCCGCTAACTGAATGGATCGAC
TGTGACACGTGTGTCCCGATCTGC -> GTGACACGTGTGTCCCGATCTGCA
CGTACGTTCTCGAAAGCTCACTGA -> GTACGTTCTCGAAAGCTCACTGAA
TATCGCCGGGGTTTGGTCCACGTG -> ATCGCCGGGGTTTGGTCCACGTGA
TCAAGCATGTTTGCGCCGGCAGAT -> CAAGCATGTTTGCGCCGGCAGATT
TGAACCCATCTCCAGGAAGTGTTG -> GAACCCATCTCCAGGAAGTGTTGC
TGTCTTGACTCCTCAGATTCTGTC -> GTCTTGACTCCTCAGATTCTGTCT
CATTTTATCGATTTTAGATCACAC -> ATTTTATCGATTTTAGATCACACA
TACGGTCCCTTTCGGATAGGGGCT -> ACGGTCCCTTTCGGATAGGGGCTT
ACACTCTAGCGTGTCTACGTCAGA -> CACTCTAGCGTGTCTACGTCAGAG
CAGTTACTCGCCTCTCTGAGAAAG -> AGTTACTCGCCTCTCTGAGAAAGT
TAGTACGTTTTTAAGCGGGATTCA -> AGTACGTTTTTAAGCGGGATTCAG
AGGAGCCGCGTTGCTCAATATGTA -> GGAGCCGCGTTGCTCAATATGTAC
GAATTGTACTCTCTGGGGTATGGC -> AATTGTACTCTCTGGGGTATGGCT
GCTGCCTTGCACCCGTGATAGCCG -> CTGCCTTGCACCCGTGATAGCCGC
GGTGTGGCGAATGCACATCCGGGA -> GTGTGGCGAATGCACATCCGGGAT
CTTCAATTTTAGGAAACCGTTTTA -> TTCAATTTTAGGAAACCGTTTTAG
CTCATACACGTAGCGCTCTGCCAT -> TCATACACGTAGCGCTCTGCCATA
ACCATCATACGGTCCTCAGTATTA -> CCATCATACGGTCCTCAGTATTAT
CCGTCCGTACAAGGTTCATAGTAC -> CGTCCGTACAAGGTTCATAGTACG
GGCTCCTTTCCGCCCATCCGCTGC -> GCTCCTTTCCGCCCATCCGCTGCC
CTTAGTTGAATACGTTTACAGGCT -> TTAGTTGAATACGTTTACAGGCTC
TGAACGCTATCAAGCAGATTCGGG -> GAACGCTATCAAGCAGATTCGGGG
CCCTCCCCGCCATGGAGGGCAAGC -> CCTCCCCGCCATGGAGGGCAAGCC
GGTACTCCTGTGGGGCGGCAAGCT -> GTACTCCTGTGGGGCGGCAAGCTT
GCAATCCATATCTTACTCAGTGTC -> CAATCCATATCTTACTCAGTGTCG
GATGCGGATTTCTGACTCGTTGCC -> ATGCGGATTTCTGACTCGTTGCCG
CTCTCTGGGGTATGGCTACACGTT -> TCTCTGGGGTATGGCTACACGTTT
TAAAGAGAATTCGAGCAATAAATT -> AAAGAGAATTCGAGCAATAAATTA
ATAAGTAGATAGGAGCCGCGTTGC -> TAAGTAGATAGGAGCCGCGTTGCT
CATGGCCTTCCACAAACGTGTACT -> ATGGCCTTCCACAAACGTGTACTC
GTTTTTAAGCGGGATTCAGTGCCA -> TTTTTAAGCGGGATTCAGTGCCAA
CTCAAGCATGTTTGCGCCGGCAGA -> TCAAGCATGTTTGCGCCGGCAGAT
CCTTGACTCAGGTTGATGCGGATT -> CTTGACTCAGGTTGATGCGGATTT
TCGTGTTTCAGAACAGCCAACCTG -> CGTGTTTCAGAACAGCCAACCTGC
GAAGGTCTGTACTAAGCGGGGCCG -> AAGGTCTGTACTAAGCGGGGCCGT
TCTGGGGTATGGCTACACGTTTGT -> CTGGGGTATGGCTACACGTTTGTG
GCTCAATATGTACTAATTGCTCGT -> CTCAATATGTACTAATTGCTCGTC
CCAGGTGCAAGGCTCCTTTCCGCC -> CAGGTGCAAGGCTCCTTTCCGCCC
AGCAGATTCGGGGCGGTGCACACC -> GCAGATTCGGGGCGGTGCACACCA
TATCTTACTCAGTGTCGGCCCGAT -> ATCTTACTCAGTGTCGGCCCGATC
GGGATGCTATCGCCGGGGTTTGGT -> GGATGCTATCGCCGGGGTTTGGTC
GAGTTATGATAAGTAGATAGGAGC -> AGTTATGATAAGTAGATAGGAGCC
TTATGAGTGAATGAACCCATCTCC -> TATGAGTGAATGAACCCATCTCCA
CATAGACTTATACCACATTTGTTG -> ATAGACTTATACCACATTTGTTGG
TGAGGGACCACGGATCACTCCATT -> GAGGGACCACGGATCACTCCATTA
TATGTACTAATTGCTCGTCGACTA -> ATGTACTAATTGCTCGTCGACTAA
TAGACTTATACCACATTTGTTGGA -> AGACTTATACCACATTTGTTGGAG
GCAAGCCCTCACCGCTTTTTCTTC -> CAAGCCCTCACCGCTTTTTCTTCC
AAATTAGTGTAACTAGTAATTTTC -> AATTAGTGTAACTAGTAATTTTCC
CATACACCACTTGGCAACAATGTG -> ATACACCACTTGGCAACAATGTGA
TGTGACGCTAAATCACCCGTGGAT -> GTGACGCTAAATCACCCGTGGATA
AGGTGAGACAGGTACTCCTGTGGG -> GGTGAGACAGGTACTCCTGTGGGG
CTTATACCACATTTGTTGGAGTTA -> TTATACCACATTTGTTGGAGTTAT
CCCTGAGTTATTGGGGCTATGGCG -> CCTGAGTTATTGGGGCTATGGCGG
CTCAGGCTACAGGAATGAATCTGT -> TCAGGCTACAGGAATGAATCTGTT
CATTGAGACTACACTCTAGCGTGT -> ATTGAGACTACACTCTAGCGTGTC
GTCCTCAGTATTATCCTTAGTTTC -> TCCTCAGTATTATCCTTAGTTTCC
TTTGCGCCGGCAGATTTCAGGAAA -> TTGCGCCGGCAGATTTCAGGAAAG
CCATATCTTACTCAGTGTCGGCCC -> CATATCTTACTCAGTGTCGGCCCG
GAGGGCAAGCCCTCACCGCTTTTT -> AGGGCAAGCCCTCACCGCTTTTTC
GGTTGCCATGTGCGGCAGTTCCTC -> GTTGCCATGTGCGGCAGTTCCTCA
GAGGTGAGACAGGTACTCCTGTGG -> AGGTGAGACAGGTACTCCTGTGGG
AGCTACCCTCCCCGCCATGGAGGG -> GCTACCCTCCCCGCCATGGAGGGC
TGCGCCGGCAGATTTCAGGAAAGA -> GCGCCGGCAGATTTCAGGAAAGAA
ATGAGTCGATTGAACGCTATCAAG -> TGAGTCGATTGAACGCTATCAAGC
TATCAAGCAGATTCGGGGCGGTGC -> ATCAAGCAGATTCGGGGCGGTGCA
CGAGCAATAAATTAGTGTAACTAG -> GAGCAATAAATTAGTGTAACTAGT
ACACGTAGCGCTCTGCCATAGACT -> CACGTAGCGCTCTGCCATAGACTT
TCCGTACGTTCTCGAAAGCTCACT -> CCGTACGTTCTCGAAAGCTCACTG
TAAATCACCCGTGGATAGTGTCAA -> AAATCACCCGTGGATAGTGTCAAA
GAACCCATCTCCAGGAAGTGTTGC -> AACCCATCTCCAGGAAGTGTTGCT
TCAGTATTATCCTTAGTTTCCCTA -> CAGTATTATCCTTAGTTTCCCTAG
AATTGTACTCTCTGGGGTATGGCT -> ATTGTACTCTCTGGGGTATGGCTA
GTGCATGGCCTTCCACAAACGTGT -> TGCATGGCCTTCCACAAACGTGTA
ATCTGCAGCTAGGAGGTATTTATG -> TCTGCAGCTAGGAGGTATTTATGT
ATAGTACGTTTTTAAGCGGGATTC -> TAGTACGTTTTTAAGCGGGATTCA
TTACGAGGACGTCTTAGTTGAATA -> TACGAGGACGTCTTAGTTGAATAC
CGTGGATAGTGTCAAATTTATCGG -> GTGGATAGTGTCAAATTTATCGGC
CGTAGGCCATTTGACGTACGAAAG -> GTAGGCCATTTGACGTACGAAAGA
ATACTTCAATTTTAGGAAACCGTT -> TACTTCAATTTTAGGAAACCGTTT
GTAGGGTTGCGGTTAGGCGTAATG -> TAGGGTTGCGGTTAGGCGTAATGG
GTAGATAGGAGCCGCGTTGCTCAA -> TAGATAGGAGCCGCGTTGCTCAAT
AACCGTCGTGCATGGCCTTCCACA -> ACCGTCGTGCATGGCCTTCCACAA
ACCACGGATCACTCCATTATCCCA -> CCACGGATCACTCCATTATCCCAA
TTCCGGGGACGGCTTAAAGAGAAT -> TCCGGGGACGGCTTAAAGAGAATT
TTTAGGAAACCGTTTTAGGGATGC -> TTAGGAAACCGTTTTAGGGATGCT
TCTCAAGCATGTTTGCGCCGGCAG -> CTCAAGCATGTTTGCGCCGGCAGA
CCTTGCACCCGTGATAGCCGCGGT -> CTTGCACCCGTGATAGCCGCGGTA
GCGCCGGCAGATTTCAGGAAAGAA -> CGCCGGCAGATTTCAGGAAAGAAC
TCCATATCTTACTCAGTGTCGGCC -> CCATATCTTACTCAGTGTCGGCCC
AGGTGTGTATTATCAGGTGACTGG -> GGTGTGTATTATCAGGTGACTGGA
GCGTGATCCGAGCCGCAATCGCGG -> CGTGATCCGAGCCGCAATCGCGGG
CGTAATTCAACAGTATGAGTCGAT -> GTAATTCAACAGTATGAGTCGATT
GTGACTGGATGGCGTAGGCCATTT -> TGACTGGATGGCGTAGGCCATTTG
GCGACGAGGGAGGTGAGACAGGTA -> CGACGAGGGAGGTGAGACAGGTAC
CAGTGTCGGCCCGATCATTTTATC -> AGTGTCGGCCCGATCATTTTATCG
GTGTCAAATTTATCGGCGTGCTCC -> TGTCAAATTTATCGGCGTGCTCCT
GTACGTTCTCGAAAGCTCACTGAA -> TACGTTCTCGAAAGCTCACTGAAA
ACTTATACCACATTTGTTGGAGTT -> CTTATACCACATTTGTTGGAGTTA
GTCGACTAAGTTCATCGCGGAATT -> TCGACTAAGTTCATCGCGGAATTG
TACACGTAGCGCTCTGCCATAGAC -> ACACGTAGCGCTCTGCCATAGACT
CAGGCTACAGGAATGAATCTGTTC -> AGGCTACAGGAATGAATCTGTTCT
ACCGTTTTAGGGATGCTATCGCCG -> CCGTTTTAGGGATGCTATCGCCGG
GTGTATTATCAGGTGACTGGATGG -> TGTATTATCAGGTGACTGGATGGC
ATCTCCAGGAAGTGTTGCTGACCC -> TCTCCAGGAAGTGTTGCTGACCCG
TTTTATCGATTTTAGATCACACAG -> TTTATCGATTTTAGATCACACAGG
TGGGCGTACCCCGTCCGTACAAGG -> GGGCGTACCCCGTCCGTACAAGGT
GTTCTCGAAAGCTCACTGAAAGTT -> TTCTCGAAAGCTCACTGAAAGTTC
GACGTACGAAAGATAGTTAACGCT -> ACGTACGAAAGATAGTTAACGCTG
CAGGTACTCCTGTGGGGCGGCAAG -> AGGTACTCCTGTGGGGCGGCAAGC
TGCTCGTCGACTAAGTTCATCGCG -> GCTCGTCGACTAAGTTCATCGCGG
TGTGGGGCGGCAAGCTTACAGTTA -> GTGGGGCGGCAAGCTTACAGTTAC
ACTTGGCAACAATGTGACACGTGT -> CTTGGCAACAATGTGACACGTGTG
AGTAGGTGTGTATTATCAGGTGAC -> GTAGGTGTGTATTATCAGGTGACT
GGATAGTGTCAAATTTATCGGCGT -> GATAGTGTCAAATTTATCGGCGTG
AACCTGCATACACCACTTGGCAAC -> ACCTGCATACACCACTTGGCAACA
ACGGCTTAAAGAGAATTCGAGCAA -> CGGCTTAAAGAGAATTCGAGCAAT
CGAATGCACATCCGGGATGGGCGT -> GAATGCACATCCGGGATGGGCGTA
CACGCGGAAGCTACGTATTCCGCT -> ACGCGGAAGCTACGTATTCCGCTA
ATTATCAGGTGACTGGATGGCGTA -> TTATCAGGTGACTGGATGGCGTAG
TCTGAGAAAGTCTCAACCCCCTGA -> CTGAGAAAGTCTCAACCCCCTGAG
AACCCCCTGAGTTATTGGGGCTAT -> ACCCCCTGAGTTATTGGGGCTATG
AAACGCGCCGTGAGCAGATTACGA -> AACGCGCCGTGAGCAGATTACGAG
TAAACTCGTGTTTCAGAACAGCCA -> AAACTCGTGTTTCAGAACAGCCAA
ACGAGGACGTCTTAGTTGAATACG -> CGAGGACGTCTTAGTTGAATACGT
TTTGGTCCACGTGACGACCAGGTG -> TTGGTCCACGTGACGACCAGGTGC
AGCCGCAATCGCGGGTCTTCCGGG -> GCCGCAATCGCGGGTCTTCCGGGC
CTACTGTCTTGACTCCTCAGATTC -> TACTGTCTTGACTCCTCAGATTCT
CCCATCTCCAGGAAGTGTTGCTGA -> CCATCTCCAGGAAGTGTTGCTGAC
CTTGTGGCGACGAGGGAGGTGAGA -> TTGTGGCGACGAGGGAGGTGAGAC
AGATTCTGTCTATCAATCCTGCCC -> GATTCTGTCTATCAATCCTGCCCC
AACTGAATGGATCGACGTTGCTCA -> ACTGAATGGATCGACGTTGCTCAT
GGCGTGCTCCTCACGCGGAAGCTA -> GCGTGCTCCTCACGCGGAAGCTAC
TAACCGTCGTGCATGGCCTTCCAC -> AACCGTCGTGCATGGCCTTCCACA
CTGACTCGTTGCCGTGGTGTGGCG -> TGACTCGTTGCCGTGGTGTGGCGA
CATATGTCGGCTCGCTACTAAAGG -> ATATGTCGGCTCGCTACTAAAGGG
ACCCATGCGTGATCCGAGCCGCAA -> CCCATGCGTGATCCGAGCCGCAAT
GACATAAGGAGGCCAGGTTGCCAT -> ACATAAGGAGGCCAGGTTGCCATG
AAACCGTTTTAGGGATGCTATCGC -> AACCGTTTTAGGGATGCTATCGCC
ATCCTAACCGTCGTGCATGGCCTT -> TCCTAACCGTCGTGCATGGCCTTC
GCCAACCTGCATACACCACTTGGC -> CCAACCTGCATACACCACTTGGCA
CCACTTGGCAACAATGTGACACGT -> CACTTGGCAACAATGTGACACGTG
GTAAAAGTAGGGTTGCGGTTAGGC -> TAAAAGTAGGGTTGCGGTTAGGCG
CGGCAGATTTCAGGAAAGAACCAT -> GGCAGATTTCAGGAAAGAACCATC
TCCGGGCAAGCACATTGAGACTAC -> CCGGGCAAGCACATTGAGACTACA
CCCCGAGGTAACTTCTTGGACCTC -> CCCGAGGTAACTTCTTGGACCTCG
GATCACTCCATTATCCCAATGTTT -> ATCACTCCATTATCCCAATGTTTG
GTGTTTCAGAACAGCCAACCTGCA -> TGTTTCAGAACAGCCAACCTGCAT
CTTGGCAACAATGTGACACGTGTG -> TTGGCAACAATGTGACACGTGTGT
TAAAAGTAGGGTTGCGGTTAGGCG -> AAAAGTAGGGTTGCGGTTAGGCGT
GATGCTATCGCCGGGGTTTGGTCC -> ATGCTATCGCCGGGGTTTGGTCCA
AATTTTCCACAACCTAGAAGCCGT -> ATTTTCCACAACCTAGAAGCCGTA
TAGATAGGAGCCGCGTTGCTCAAT -> AGATAGGAGCCGCGTTGCTCAATA
CTTGCACCCGTGATAGCCGCGGTA -> TTGCACCCGTGATAGCCGCGGTAC
TCATAGTACGTTTTTAAGCGGGAT -> CATAGTACGTTTTTAAGCGGGATT
CAGATTCTGTCTATCAATCCTGCC -> AGATTCTGTCTATCAATCCTGCCC
CTCGGTTCCGTACGTTCTCGAAAG -> TCGGTTCCGTACGTTCTCGAAAGC
TCAACCCCCTGAGTTATTGGGGCT -> CAACCCCCTGAGTTATTGGGGCTA
AGGTTCATAGTACGTTTTTAAGCG -> GGTTCATAGTACGTTTTTAAGCGG
TCCTAAGCAATCCATATCTTACTC -> CCTAAGCAATCCATATCTTACTCA
ATTTTCTCAAGCATGTTTGCGCCG -> TTTTCTCAAGCATGTTTGCGCCGG
ATATCTTACTCAGTGTCGGCCCGA -> TATCTTACTCAGTGTCGGCCCGAT
GGGGCGGCAAGCTTACAGTTACTC -> GGGCGGCAAGCTTACAGTTACTCG
ATTTCTGACTCGTTGCCGTGGTGT -> TTTCTGACTCGTTGCCGTGGTGTG
GTGACACGTGTGTCCCGATCTGCA -> TGACACGTGTGTCCCGATCTGCAG
GCCCCGAGGTAACTTCTTGGACCT -> CCCCGAGGTAACTTCTTGGACCTC
CCCAATGTTTGTGGTAAAAGTAGG -> CCAATGTTTGTGGTAAAAGTAGGG
TTATTGGGGCTATGGCGGTCGCCA -> TATTGGGGCTATGGCGGTCGCCAT
ACAGGTTATATTTTCTCAAGCATG -> CAGGTTATATTTTCTCAAGCATGT
TTTTTAAGCGGGATTCAGTGCCAA -> TTTTAAGCGGGATTCAGTGCCAAG
TGTCTATCAATCCTGCCCCGAGGT -> GTCTATCAATCCTGCCCCGAGGTA
GGGTCATGAGATCAGAAACGCGCC -> GGTCATGAGATCAGAAACGCGCCG
CTCCAGGAAGTGTTGCTGACCCGT -> TCCAGGAAGTGTTGCTGACCCGTC
ATTCAGTGCCAAGCCGTAGTAGGT -> TTCAGTGCCAAGCCGTAGTAGGTG
CATGGAGGGCAAGCCCTCACCGCT -> ATGGAGGGCAAGCCCTCACCGCTT
ACCCCCTGAGTTATTGGGGCTATG -> CCCCCTGAGTTATTGGGGCTATGG
GACTCAGGTTGATGCGGATTTCTG -> ACTCAGGTTGATGCGGATTTCTGA
CCATAGACTTATACCACATTTGTT -> CATAGACTTATACCACATTTGTTG
CGCTCTGCCATAGACTTATACCAC -> GCTCTGCCATAGACTTATACCACA
CCTCATACACGTAGCGCTCTGCCA -> CTCATACACGTAGCGCTCTGCCAT
AGATTTCAGGAAAGAACCATCATA -> GATTTCAGGAAAGAACCATCATAC
GACTAAGTTCATCGCGGAATTGTA -> ACTAAGTTCATCGCGGAATTGTAC
CAACCCCCTGAGTTATTGGGGCTA -> AACCCCCTGAGTTATTGGGGCTAT
AGGTATTTATGTTTATGAGTGAAT -> GGTATTTATGTTTATGAGTGAATG
GCTACACGTTTGTGACGCTAAATC -> CTACACGTTTGTGACGCTAAATCA
GGCAACAATGTGACACGTGTGTCC -> GCAACAATGTGACACGTGTGTCCC
GACACTTGTGGCGACGAGGGAGGT -> ACACTTGTGGCGACGAGGGAGGTG
TCCGGGATGGGCGTACCCCGTCCG -> CCGGGATGGGCGTACCCCGTCCGT
AGGCGTAATGGAGATCCTAAGCAA -> GGCGTAATGGAGATCCTAAGCAAT
AGATAGGAGCCGCGTTGCTCAATA -> GATAGGAGCCGCGTTGCTCAATAT
TATGGCTACACGTTTGTGACGCTA -> ATGGCTACACGTTTGTGACGCTAA
GCAACAGTTAGGACACAACACCAA -> CAACAGTTAGGACACAACACCAAG
CGTGATAGCCGCGGTACGTCCCAG -> GTGATAGCCGCGGTACGTCCCAGG
AGAGGCCGAGAGCTACCCTCCCCG -> GAGGCCGAGAGCTACCCTCCCCGC
GACGGGTCATGAGATCAGAAACGC -> ACGGGTCATGAGATCAGAAACGCG
GTATTTATGTTTATGAGTGAATGA -> TATTTATGTTTATGAGTGAATGAA
TCCGCTGCCTTGCACCCGTGATAG -> CCGCTGCCTTGCACCCGTGATAGC
ATGGCTACACGTTTGTGACGCTAA -> TGGCTACACGTTTGTGACGCTAAA
CGTTTACAGGCTCACATATAGTTC -> GTTTACAGGCTCACATATAGTTCG
CGCGGTACGTCCCAGGATAACCCA -> GCGGTACGTCCCAGGATAACCCAT
TCCACGTGACGACCAGGTGCAAGG -> CCACGTGACGACCAGGTGCAAGGC
CCTTTCCGCCCATCCGCTGCCTTG -> CTTTCCGCCCATCCGCTGCCTTGC
GCACCCGTGATAGCCGCGGTACGT -> CACCCGTGATAGCCGCGGTACGTC
GTCGGCTCGCTACTAAAGGGAGAG -> TCGGCTCGCTACTAAAGGGAGAGT
CCGTAGTAGGTGTGTATTATCAGG -> CGTAGTAGGTGTGTATTATCAGGT
CACAGGTTATATTTTCTCAAGCAT -> ACAGGTTATATTTTCTCAAGCATG
GTAACTAGTAATTTTCCACAACCT -> TAACTAGTAATTTTCCACAACCTA
TGGAGATCCTAAGCAATCCATATC -> GGAGATCCTAAGCAATCCATATCT
AATGGATCGACGTTGCTCATTATC -> ATGGATCGACGTTGCTCATTATCG
GGCGTAATGGAGATCCTAAGCAAT -> GCGTAATGGAGATCCTAAGCAATC
GACCAGGTGCAAGGCTCCTTTCCG -> ACCAGGTGCAAGGCTCCTTTCCGC
GCTATGGCGGTCGCCATTGTATTG -> CTATGGCGGTCGCCATTGTATTGG
TAGAGTACGGTCCCTTTCGGATAG -> AGAGTACGGTCCCTTTCGGATAGG
ACCCGTCTTGAGGCCTTGACTCAG -> CCCGTCTTGAGGCCTTGACTCAGG
AGACAGGTACTCCTGTGGGGCGGC -> GACAGGTACTCCTGTGGGGCGGCA
TAACTTCTTGGACCTCGGTTCCGT -> AACTTCTTGGACCTCGGTTCCGTA
GTGAAGGTCTGTACTAAGCGGGGC -> TGAAGGTCTGTACTAAGCGGGGCC
TTTATGTTTATGAGTGAATGAACC -> TTATGTTTATGAGTGAATGAACCC
AAGGCTCCTTTCCGCCCATCCGCT -> AGGCTCCTTTCCGCCCATCCGCTG
TTCTATCCTAACCGTCGTGCATGG -> TCTATCCTAACCGTCGTGCATGGC
AAGCCGTAATTCAACAGTATGAGT -> AGCCGTAATTCAACAGTATGAGTC
TTCTCAAGCATGTTTGCGCCGGCA -> TCTCAAGCATGTTTGCGCCGGCAG
AGTTATCATATGTCGGCTCGCTAC -> GTTATCATATGTCGGCTCGCTACT
TAGTTATCATATGTCGGCTCGCTA -> AGTTATCATATGTCGGCTCGCTAC
CGCCATGGAGGGCAAGCCCTCACC -> GCCATGGAGGGCAAGCCCTCACCG
CAGAAACGCGCCGTGAGCAGATTA -> AGAAACGCGCCGTGAGCAGATTAC
CCGGGCAAGCACATTGAGACTACA -> CGGGCAAGCACATTGAGACTACAC
CTTACTCAGTGTCGGCCCGATCAT -> TTACTCAGTGTCGGCCCGATCATT
ACGTATTCCGCTAACTGAATGGAT -> CGTATTCCGCTAACTGAATGGATC
GGTCGCCATTGTATTGGAAGCCGC -> GTCGCCATTGTATTGGAAGCCGCT
GAGTGAAGGTCTGTACTAAGCGGG -> AGTGAAGGTCTGTACTAAGCGGGG
ACTCCTCAGATTCTGTCTATCAAT -> CTCCTCAGATTCTGTCTATCAATC
CGTCCCAGGATAACCCATGCGTGA -> GTCCCAGGATAACCCATGCGTGAT
AACGTGTACTCGACCTGTAGAGTA -> ACGTGTACTCGACCTGTAGAGTAC
ATTATCCTTAGTTTCCCTAGCCCA -> TTATCCTTAGTTTCCCTAGCCCAG
TCAACAGTATGAGTCGATTGAACG -> CAACAGTATGAGTCGATTGAACGC
AGTAGATAGGAGCCGCGTTGCTCA -> GTAGATAGGAGCCGCGTTGCTCAA
TTGACTCCTCAGATTCTGTCTATC -> TGACTCCTCAGATTCTGTCTATCA
GTGACGACCAGGTGCAAGGCTCCT -> TGACGACCAGGTGCAAGGCTCCTT
ACACGTTTGTGACGCTAAATCACC -> CACGTTTGTGACGCTAAATCACCC
TACTCAGTGTCGGCCCGATCATTT -> ACTCAGTGTCGGCCCGATCATTTT
TAGTTAACGCTGAGGGACCACGGA -> AGTTAACGCTGAGGGACCACGGAT
AGATAGTTAACGCTGAGGGACCAC -> GATAGTTAACGCTGAGGGACCACG
CGGTGCACACCAGGACATAAGGAG -> GGTGCACACCAGGACATAAGGAGG
ATTACGAGGACGTCTTAGTTGAAT -> TTACGAGGACGTCTTAGTTGAATA
ATTCGATAGTTATCATATGTCGGC -> TTCGATAGTTATCATATGTCGGCT
TGTGGTAAAAGTAGGGTTGCGGTT -> GTGGTAAAAGTAGGGTTGCGGTTA
TTTTCCACAACCTAGAAGCCGTAA -> TTTCCACAACCTAGAAGCCGTAAT
CTCAGGTTGATGCGGATTTCTGAC -> TCAGGTTGATGCGGATTTCTGACT
AGATCCTAAGCAATCCATATCTTA -> GATCCTAAGCAATCCATATCTTAC
ACAAACGTGTACTCGACCTGTAGA -> CAAACGTGTACTCGACCTGTAGAG
TTAGGGATGCTATCGCCGGGGTTT -> TAGGGATGCTATCGCCGGGGTTTG
GGGATTCAGTGCCAAGCCGTAGTA -> GGATTCAGTGCCAAGCCGTAGTAG
CCACGTGACGACCAGGTGCAAGGC -> CACGTGACGACCAGGTGCAAGGCT
GACTTATACCACATTTGTTGGAGT -> ACTTATACCACATTTGTTGGAGTT
CTCAACCCCCTGAGTTATTGGGGC -> TCAACCCCCTGAGTTATTGGGGCT
GCGTTGCTCAATATGTACTAATTG -> CGTTGCTCAATATGTACTAATTGC
ATCCGGGATGGGCGTACCCCGTCC -> TCCGGGATGGGCGTACCCCGTCCG
TACTGTCTTGACTCCTCAGATTCT -> ACTGTCTTGACTCCTCAGATTCTG
TAAACTACTGTCTTGACTCCTCAG -> AAACTACTGTCTTGACTCCTCAGA
TAATTTTCCACAACCTAGAAGCCG -> AATTTTCCACAACCTAGAAGCCGT
GTATCCATAAACTCGTGTTTCAGA -> TATCCATAAACTCGTGTTTCAGAA
GAATCTGTTCTTACTAAACTACTG -> AATCTGTTCTTACTAAACTACTGT
TGATAAGTAGATAGGAGCCGCGTT -> GATAAGTAGATAGGAGCCGCGTTG
TTCTTCCGGGGACGGCTTAAAGAG -> TCTTCCGGGGACGGCTTAAAGAGA
AGACTACACTCTAGCGTGTCTACG -> GACTACACTCTAGCGTGTCTACGT
GCTTAAAGAGAATTCGAGCAATAA -> CTTAAAGAGAATTCGAGCAATAAA
GTGGTGTGGCGAATGCACATCCGG -> TGGTGTGGCGAATGCACATCCGGG
GACTGGATGGCGTAGGCCATTTGA -> ACTGGATGGCGTAGGCCATTTGAC
CCCCCTGAGTTATTGGGGCTATGG -> CCCCTGAGTTATTGGGGCTATGGC
CACAACACCAAGACACTTGTGGCG -> ACAACACCAAGACACTTGTGGCGA
CAGAACAGCCAACCTGCATACACC -> AGAACAGCCAACCTGCATACACCA
TTGGTATCCATAAACTCGTGTTTC -> TGGTATCCATAAACTCGTGTTTCA
TCTGTTCTTACTAAACTACTGTCT -> CTGTTCTTACTAAACTACTGTCTT
ACATTTGTTGGAGTTATGATAAGT -> CATTTGTTGGAGTTATGATAAGTA
TAGGAGGTATTTATGTTTATGAGT -> AGGAGGTATTTATGTTTATGAGTG
GGTCCTCAGTATTATCCTTAGTTT -> GTCCTCAGTATTATCCTTAGTTTC
AATCACCCGTGGATAGTGTCAAAT -> ATCACCCGTGGATAGTGTCAAATT
AGAATTCGAGCAATAAATTAGTGT -> GAATTCGAGCAATAAATTAGTGTA
GCGGTGCACACCAGGACATAAGGA -> CGGTGCACACCAGGACATAAGGAG
ACGCTGAGGGACCACGGATCACTC -> CGCTGAGGGACCACGGATCACTCC
GTGGATAGTGTCAAATTTATCGGC -> TGGATAGTGTCAAATTTATCGGCG
TGGATCGACGTTGCTCATTATCGA -> GGATCGACGTTGCTCATTATCGAG
TCAATTTTAGGAAACCGTTTTAGG -> CAATTTTAGGAAACCGTTTTAGGG
TGCTCCTCACGCGGAAGCTACGTA -> GCTCCTCACGCGGAAGCTACGTAT
AAATCACCCGTGGATAGTGTCAAA -> AATCACCCGTGGATAGTGTCAAAT
ACTTCTTGGACCTCGGTTCCGTAC -> CTTCTTGGACCTCGGTTCCGTACG
GCGGAAGCTACGTATTCCGCTAAC -> CGGAAGCTACGTATTCCGCTAACT
ACCTAGAAGCCGTAATTCAACAGT -> CCTAGAAGCCGTAATTCAACAGTA
GAACAGCCAACCTGCATACACCAC -> AACAGCCAACCTGCATACACCACT
GCTATCAAGCAGATTCGGGGCGGT -> CTATCAAGCAGATTCGGGGCGGTG
CATTATCCCAATGTTTGTGGTAAA -> ATTATCCCAATGTTTGTGGTAAAA
GTATTCCGCTAACTGAATGGATCG -> TATTCCGCTAACTGAATGGATCGA
AGGGATGCTATCGCCGGGGTTTGG -> GGGATGCTATCGCCGGGGTTTGGT
AAAAGTAGGGTTGCGGTTAGGCGT -> AAAGTAGGGTTGCGGTTAGGCGTA
CAATCCATATCTTACTCAGTGTCG -> AATCCATATCTTACTCAGTGTCGG
GCAAGCTTACAGTTACTCGCCTCT -> CAAGCTTACAGTTACTCGCCTCTC
CTGTGGGGCGGCAAGCTTACAGTT -> TGTGGGGCGGCAAGCTTACAGTTA
ATTGTATTGGAAGCCGCTAACAAT -> TTGTATTGGAAGCCGCTAACAATT
GGGTATGGCTACACGTTTGTGACG -> GGTATGGCTACACGTTTGTGACGC
GGAAGTGTTGCTGACCCGTCTTGA -> GAAGTGTTGCTGACCCGTCTTGAG
TCCATAAACTCGTGTTTCAGAACA -> CCATAAACTCGTGTTTCAGAACAG
TGTGGCGACGAGGGAGGTGAGACA -> GTGGCGACGAGGGAGGTGAGACAG
ATCCGCTGCCTTGCACCCGTGATA -> TCCGCTGCCTTGCACCCGTGATAG
TTTCGGATAGGGGCTTGGTATCCA -> TTCGGATAGGGGCTTGGTATCCAT
AGCATGTTTGCGCCGGCAGATTTC -> GCATGTTTGCGCCGGCAGATTTCA
GGGGCTATGGCGGTCGCCATTGTA -> GGGCTATGGCGGTCGCCATTGTAT
TTCCGGGCAAGCACATTGAGACTA -> TCCGGGCAAGCACATTGAGACTAC
GAGGCCGAGAGCTACCCTCCCCGC -> AGGCCGAGAGCTACCCTCCCCGCC
TCTGCAGCTAGGAGGTATTTATGT -> CTGCAGCTAGGAGGTATTTATGTT
ATTAGTGTAACTAGTAATTTTCCA -> TTAGTGTAACTAGTAATTTTCCAC
CGCAATCGCGGGTCTTCCGGGCAA -> GCAATCGCGGGTCTTCCGGGCAAG
CTCACCGCTTTTTCTTCCGGGGAC -> TCACCGCTTTTTCTTCCGGGGACG
CAGGAAAGAACCATCATACGGTCC -> AGGAAAGAACCATCATACGGTCCT
ATGCGGATTTCTGACTCGTTGCCG -> TGCGGATTTCTGACTCGTTGCCGT
AACACCAAGACACTTGTGGCGACG -> ACACCAAGACACTTGTGGCGACGA
CATTGTATTGGAAGCCGCTAACAA -> ATTGTATTGGAAGCCGCTAACAAT
TCCATTATCCCAATGTTTGTGGTA -> CCATTATCCCAATGTTTGTGGTAA
GGTCATGAGATCAGAAACGCGCCG -> GTCATGAGATCAGAAACGCGCCGT
TTGACTCAGGTTGATGCGGATTTC -> TGACTCAGGTTGATGCGGATTTCT
CTCCATTATCCCAATGTTTGTGGT -> TCCATTATCCCAATGTTTGTGGTA
CCCTTTCGGATAGGGGCTTGGTAT -> CCTTTCGGATAGGGGCTTGGTATC
TGCACCCGTGATAGCCGCGGTACG -> GCACCCGTGATAGCCGCGGTACGT
GCCAGGTTGCCATGTGCGGCAGTT -> CCAGGTTGCCATGTGCGGCAGTTC
GTGGCGAATGCACATCCGGGATGG -> TGGCGAATGCACATCCGGGATGGG
TCGTACATACTTCAATTTTAGGAA -> CGTACATACTTCAATTTTAGGAAA
GGCAGATTTCAGGAAAGAACCATC -> GCAGATTTCAGGAAAGAACCATCA
CTAACAATTCGATAGTTATCATAT -> TAACAATTCGATAGTTATCATATG
GCATACACCACTTGGCAACAATGT -> CATACACCACTTGGCAACAATGTG
ACGTGTACTCGACCTGTAGAGTAC -> CGTGTACTCGACCTGTAGAGTACG
CACATCCGGGATGGGCGTACCCCG -> ACATCCGGGATGGGCGTACCCCGT
ATCGCCGGGGTTTGGTCCACGTGA -> TCGCCGGGGTTTGGTCCACGTGAC
AGGAGGCCAGGTTGCCATGTGCGG -> GGAGGCCAGGTTGCCATGTGCGGC
CCGTTTTAGGGATGCTATCGCCGG -> CGTTTTAGGGATGCTATCGCCGGG
TAGCGTGTCTACGTCAGAGGCCGA -> AGCGTGTCTACGTCAGAGGCCGAG
TTAGGCGTAATGGAGATCCTAAGC -> TAGGCGTAATGGAGATCCTAAGCA
TCCTTAGTTTCCCTAGCCCAGCGC -> CCTTAGTTTCCCTAGCCCAGCGCA
TACCCTCCCCGCCATGGAGGGCAA -> ACCCTCCCCGCCATGGAGGGCAAG
CTCACTGAAAGTTCTATCCTAACC -> TCACTGAAAGTTCTATCCTAACCG
CCTCGGTTCCGTACGTTCTCGAAA -> CTCGGTTCCGTACGTTCTCGAAAG
GTTAACGCTGAGGGACCACGGATC -> TTAACGCTGAGGGACCACGGATCA
CTTGAGGCCTTGACTCAGGTTGAT -> TTGAGGCCTTGACTCAGGTTGATG
AGCTAGGAGGTATTTATGTTTATG -> GCTAGGAGGTATTTATGTTTATGA
TTCCGCTAACTGAATGGATCGACG -> TCCGCTAACTGAATGGATCGACGT
ACTAAGCGGGGCCGTCGACGGGTC -> CTAAGCGGGGCCGTCGACGGGTCA
GTAGCGCTCTGCCATAGACTTATA -> TAGCGCTCTGCCATAGACTTATAC
ATCTTACTCAGTGTCGGCCCGATC -> TCTTACTCAGTGTCGGCCCGATCA
TCCTAACCGTCGTGCATGGCCTTC -> CCTAACCGTCGTGCATGGCCTTCC
CAGGAAGTGTTGCTGACCCGTCTT -> AGGAAGTGTTGCTGACCCGTCTTG
CCAACCTGCATACACCACTTGGCA -> CAACCTGCATACACCACTTGGCAA
GGTGAGACAGGTACTCCTGTGGGG -> GTGAGACAGGTACTCCTGTGGGGC
TACGTTTTTAAGCGGGATTCAGTG -> ACGTTTTTAAGCGGGATTCAGTGC
CATGAGATCAGAAACGCGCCGTGA -> ATGAGATCAGAAACGCGCCGTGAG
TCGCCGGGGTTTGGTCCACGTGAC -> CGCCGGGGTTTGGTCCACGTGACG
AAGTTCTATCCTAACCGTCGTGCA -> AGTTCTATCCTAACCGTCGTGCAT
CATCCGGGATGGGCGTACCCCGTC -> ATCCGGGATGGGCGTACCCCGTCC
ATAGGGGCTTGGTATCCATAAACT -> TAGGGGCTTGGTATCCATAAACTC
TCATCGCGGAATTGTACTCTCTGG -> CATCGCGGAATTGTACTCTCTGGG
CGACGAGGGAGGTGAGACAGGTAC -> GACGAGGGAGGTGAGACAGGTACT
ACAAGGTTCATAGTACGTTTTTAA -> CAAGGTTCATAGTACGTTTTTAAG
GATTTCTGACTCGTTGCCGTGGTG -> ATTTCTGACTCGTTGCCGTGGTGT
AACCATCATACGGTCCTCAGTATT -> ACCATCATACGGTCCTCAGTATTA
GTGCGGCAGTTCCTCATACACGTA -> TGCGGCAGTTCCTCATACACGTAG
ACTGTCTTGACTCCTCAGATTCTG -> CTGTCTTGACTCCTCAGATTCTGT
CTTGACTCCTCAGATTCTGTCTAT -> TTGACTCCTCAGATTCTGTCTATC
CGACGGGTCATGAGATCAGAAACG -> GACGGGTCATGAGATCAGAAACGC
GGACATAAGGAGGCCAGGTTGCCA -> GACATAAGGAGGCCAGGTTGCCAT
TTGTGACGCTAAATCACCCGTGGA -> TGTGACGCTAAATCACCCGTGGAT
TGTCAAATTTATCGGCGTGCTCCT -> GTCAAATTTATCGGCGTGCTCCTC
CTGTTCTTACTAAACTACTGTCTT -> TGTTCTTACTAAACTACTGTCTTG
TGGCTACACGTTTGTGACGCTAAA -> GGCTACACGTTTGTGACGCTAAAT
GCTACTAAAGGGAGAGTGAAGGTC -> CTACTAAAGGGAGAGTGAAGGTCT
AGTTCGTACATACTTCAATTTTAG -> GTTCGTACATACTTCAATTTTAGG
CAACCTAGAAGCCGTAATTCAACA -> AACCTAGAAGCCGTAATTCAACAG
TTATATTTTCTCAAGCATGTTTGC -> TATATTTTCTCAAGCATGTTTGCG
TTCAGAACAGCCAACCTGCATACA -> TCAGAACAGCCAACCTGCATACAC
GTGTCTACGTCAGAGGCCGAGAGC -> TGTCTACGTCAGAGGCCGAGAGCT
CCGCGGTACGTCCCAGGATAACCC -> CGCGGTACGTCCCAGGATAACCCA
TTGAATACGTTTACAGGCTCACAT -> TGAATACGTTTACAGGCTCACATA
ATGAGTGAATGAACCCATCTCCAG -> TGAGTGAATGAACCCATCTCCAGG
GGTTGATGCGGATTTCTGACTCGT -> GTTGATGCGGATTTCTGACTCGTT
CTTGGACCTCGGTTCCGTACGTTC -> TTGGACCTCGGTTCCGTACGTTCT
CCCGTCTTGAGGCCTTGACTCAGG -> CCGTCTTGAGGCCTTGACTCAGGT
GCCGCGGTACGTCCCAGGATAACC -> CCGCGGTACGTCCCAGGATAACCC
GAGCAGATTACGAGGACGTCTTAG -> AGCAGATTACGAGGACGTCTTAGT
AACTTCTTGGACCTCGGTTCCGTA -> ACTTCTTGGACCTCGGTTCCGTAC
ATTGAACGCTATCAAGCAGATTCG -> TTGAACGCTATCAAGCAGATTCGG
ACAATGTGACACGTGTGTCCCGAT -> CAATGTGACACGTGTGTCCCGATC
CTGAGAAAGTCTCAACCCCCTGAG -> TGAGAAAGTCTCAACCCCCTGAGT
CGGCAGTTCCTCATACACGTAGCG -> GGCAGTTCCTCATACACGTAGCGC
AGTGTCAAATTTATCGGCGTGCTC -> GTGTCAAATTTATCGGCGTGCTCC
CCCGCCATGGAGGGCAAGCCCTCA -> CCGCCATGGAGGGCAAGCCCTCAC
GCTCATTATCGAGGGCCTATATAT -> CTCATTATCGAGGGCCTATATATT
CAGGTGCAAGGCTCCTTTCCGCCC -> AGGTGCAAGGCTCCTTTCCGCCCA
CAGATTACGAGGACGTCTTAGTTG -> AGATTACGAGGACGTCTTAGTTGA
TTTTCTTCCGGGGACGGCTTAAAG -> TTTCTTCCGGGGACGGCTTAAAGA
CAGAGGCCGAGAGCTACCCTCCCC -> AGAGGCCGAGAGCTACCCTCCCCG
TTTTCTCAAGCATGTTTGCGCCGG -> TTTCTCAAGCATGTTTGCGCCGGC
TTACAGGCTCACATATAGTTCGTA -> TACAGGCTCACATATAGTTCGTAC
TGATCCGAGCCGCAATCGCGGGTC -> GATCCGAGCCGCAATCGCGGGTCT
TTATCGGCGTGCTCCTCACGCGGA -> TATCGGCGTGCTCCTCACGCGGAA
TTCCTCATACACGTAGCGCTCTGC -> TCCTCATACACGTAGCGCTCTGCC
GGCGGTGCACACCAGGACATAAGG -> GCGGTGCACACCAGGACATAAGGA
CGGAATTGTACTCTCTGGGGTATG -> GGAATTGTACTCTCTGGGGTATGG
TTGAACGCTATCAAGCAGATTCGG -> TGAACGCTATCAAGCAGATTCGGG
GCTCGCTACTAAAGGGAGAGTGAA -> CTCGCTACTAAAGGGAGAGTGAAG
TGCGGATTTCTGACTCGTTGCCGT -> GCGGATTTCTGACTCGTTGCCGTG
CCTTTCGGATAGGGGCTTGGTATC -> CTTTCGGATAGGGGCTTGGTATCC
GGCGACGAGGGAGGTGAGACAGGT -> GCGACGAGGGAGGTGAGACAGGTA
AAGCTACGTATTCCGCTAACTGAA -> AGCTACGTATTCCGCTAACTGAAT
TGACCCGTCTTGAGGCCTTGACTC -> GACCCGTCTTGAGGCCTTGACTCA
GTGCAAGGCTCCTTTCCGCCCATC -> TGCAAGGCTCCTTTCCGCCCATCC
TTGAGGCCTTGACTCAGGTTGATG -> TGAGGCCTTGACTCAGGTTGATGC
AAGCAGATTCGGGGCGGTGCACAC -> AGCAGATTCGGGGCGGTGCACACC
AACTCGTGTTTCAGAACAGCCAAC -> ACTCGTGTTTCAGAACAGCCAACC
TCTTGACTCCTCAGATTCTGTCTA -> CTTGACTCCTCAGATTCTGTCTAT
TTTGTGACGCTAAATCACCCGTGG -> TTGTGACGCTAAATCACCCGTGGA
GCTCTGCCATAGACTTATACCACA -> CTCTGCCATAGACTTATACCACAT
AGACAGTCTGCAATGTATCCTCAG -> GACAGTCTGCAATGTATCCTCAGG
GGTCCCTTTCGGATAGGGGCTTGG -> GTCCCTTTCGGATAGGGGCTTGGT
TAAGCGGGGCCGTCGACGGGTCAT -> AAGCGGGGCCGTCGACGGGTCATG
CGATAGTTATCATATGTCGGCTCG -> GATAGTTATCATATGTCGGCTCGC
TTGCGCCGGCAGATTTCAGGAAAG -> TGCGCCGGCAGATTTCAGGAAAGA
CAATAAATTAGTGTAACTAGTAAT -> AATAAATTAGTGTAACTAGTAATT
GGCTCGCTACTAAAGGGAGAGTGA -> GCTCGCTACTAAAGGGAGAGTGAA
CAGATTTCAGGAAAGAACCATCAT -> AGATTTCAGGAAAGAACCATCATA
GAAAGAACCATCATACGGTCCTCA -> AAAGAACCATCATACGGTCCTCAG
CTATCGCCGGGGTTTGGTCCACGT -> TATCGCCGGGGTTTGGTCCACGTG
ACAGTCTGCAATGTATCCTCAGGC -> CAGTCTGCAATGTATCCTCAGGCT
CGTTTGTGACGCTAAATCACCCGT -> GTTTGTGACGCTAAATCACCCGTG
GATAGTGTCAAATTTATCGGCGTG -> ATAGTGTCAAATTTATCGGCGTGC
CACTTGTGGCGACGAGGGAGGTGA -> ACTTGTGGCGACGAGGGAGGTGAG
CTCATTATCGAGGGCCTATATATT -> TCATTATCGAGGGCCTATATATTA
ATTTTAGGAAACCGTTTTAGGGAT -> TTTTAGGAAACCGTTTTAGGGATG
AGCCCTCACCGCTTTTTCTTCCGG -> GCCCTCACCGCTTTTTCTTCCGGG
CAAATTTATCGGCGTGCTCCTCAC -> AAATTTATCGGCGTGCTCCTCACG
GCTCGTCGACTAAGTTCATCGCGG -> CTCGTCGACTAAGTTCATCGCGGA
TTGCGGTTAGGCGTAATGGAGATC -> TGCGGTTAGGCGTAATGGAGATCC
TTAACGCTGAGGGACCACGGATCA -> TAACGCTGAGGGACCACGGATCAC
CCAGGATAACCCATGCGTGATCCG -> CAGGATAACCCATGCGTGATCCGA
ATGGAGATCCTAAGCAATCCATAT -> TGGAGATCCTAAGCAATCCATATC
CATACTTCAATTTTAGGAAACCGT -> ATACTTCAATTTTAGGAAACCGTT
ATAGACTTATACCACATTTGTTGG -> TAGACTTATACCACATTTGTTGGA
CGATTTTAGATCACACAGGTTATA -> GATTTTAGATCACACAGGTTATAT
ATCTGTTCTTACTAAACTACTGTC -> TCTGTTCTTACTAAACTACTGTCT
GTATGAGTCGATTGAACGCTATCA -> TATGAGTCGATTGAACGCTATCAA
AGAACCATCATACGGTCCTCAGTA -> GAACCATCATACGGTCCTCAGTAT
ATTGTACTCTCTGGGGTATGGCTA -> TTGTACTCTCTGGGGTATGGCTAC
CCATGGAGGGCAAGCCCTCACCGC -> CATGGAGGGCAAGCCCTCACCGCT
CGGCTCGCTACTAAAGGGAGAGTG -> GGCTCGCTACTAAAGGGAGAGTGA
CCTAACCGTCGTGCATGGCCTTCC -> CTAACCGTCGTGCATGGCCTTCCA
TATGATAAGTAGATAGGAGCCGCG -> ATGATAAGTAGATAGGAGCCGCGT
CAGGATAACCCATGCGTGATCCGA -> AGGATAACCCATGCGTGATCCGAG
ACAGTTACTCGCCTCTCTGAGAAA -> CAGTTACTCGCCTCTCTGAGAAAG
GCGGGTCTTCCGGGCAAGCACATT -> CGGGTCTTCCGGGCAAGCACATTG
TCCGCCCATCCGCTGCCTTGCACC -> CCGCCCATCCGCTGCCTTGCACCC
AGCCCAGCGCAACAGTTAGGACAC -> GCCCAGCGCAACAGTTAGGACACA
CTTCCGGGCAAGCACATTGAGACT -> TTCCGGGCAAGCACATTGAGACTA
CTTACTAAACTACTGTCTTGACTC -> TTACTAAACTACTGTCTTGACTCC
TCTTACTCAGTGTCGGCCCGATCA -> CTTACTCAGTGTCGGCCCGATCAT
CTCGTCGACTAAGTTCATCGCGGA -> TCGTCGACTAAGTTCATCGCGGAA
CTAACCGTCGTGCATGGCCTTCCA -> TAACCGTCGTGCATGGCCTTCCAC
TCTGTCTATCAATCCTGCCCCGAG -> CTGTCTATCAATCCTGCCCCGAGG
GATCAGAAACGCGCCGTGAGCAGA -> ATCAGAAACGCGCCGTGAGCAGAT
AGACTTATACCACATTTGTTGGAG -> GACTTATACCACATTTGTTGGAGT
GAGAGCTACCCTCCCCGCCATGGA -> AGAGCTACCCTCCCCGCCATGGAG
TCGTCGACTAAGTTCATCGCGGAA -> CGTCGACTAAGTTCATCGCGGAAT
AGATCAGAAACGCGCCGTGAGCAG -> GATCAGAAACGCGCCGTGAGCAGA
CGGGATGGGCGTACCCCGTCCGTA -> GGGATGGGCGTACCCCGTCCGTAC
CTACAGGAATGAATCTGTTCTTAC -> TACAGGAATGAATCTGTTCTTACT
TCACGCGGAAGCTACGTATTCCGC -> CACGCGGAAGCTACGTATTCCGCT
GTCTTCCGGGCAAGCACATTGAGA -> TCTTCCGGGCAAGCACATTGAGAC
AGCCGCTAACAATTCGATAGTTAT -> GCCGCTAACAATTCGATAGTTATC
AGGACACAACACCAAGACACTTGT -> GGACACAACACCAAGACACTTGTG
GTGGCGACGAGGGAGGTGAGACAG -> TGGCGACGAGGGAGGTGAGACAGG
CAGTTAGGACACAACACCAAGACA -> AGTTAGGACACAACACCAAGACAC
AACGCTGAGGGACCACGGATCACT -> ACGCTGAGGGACCACGGATCACTC
ATCACTCCATTATCCCAATGTTTG -> TCACTCCATTATCCCAATGTTTGT
TCAGGTGACTGGATGGCGTAGGCC -> CAGGTGACTGGATGGCGTAGGCCA
AATGTTTGTGGTAAAAGTAGGGTT -> ATGTTTGTGGTAAAAGTAGGGTTG
GGCTTAAAGAGAATTCGAGCAATA -> GCTTAAAGAGAATTCGAGCAATAA
CCTAGAAGCCGTAATTCAACAGTA -> CTAGAAGCCGTAATTCAACAGTAT
TTATCCCAATGTTTGTGGTAAAAG -> TATCCCAATGTTTGTGGTAAAAGT
CCTAAGCAATCCATATCTTACTCA -> CTAAGCAATCCATATCTTACTCAG
GGGAGGTGAGACAGGTACTCCTGT -> GGAGGTGAGACAGGTACTCCTGTG
ACGGGTCATGAGATCAGAAACGCG -> CGGGTCATGAGATCAGAAACGCGC
CAAGCTTACAGTTACTCGCCTCTC -> AAGCTTACAGTTACTCGCCTCTCT
GCCCATCCGCTGCCTTGCACCCGT -> CCCATCCGCTGCCTTGCACCCGTG
CAGGTGACTGGATGGCGTAGGCCA -> AGGTGACTGGATGGCGTAGGCCAT
CAGGCTCACATATAGTTCGTACAT -> AGGCTCACATATAGTTCGTACATA
TTGGAGTTATGATAAGTAGATAGG -> TGGAGTTATGATAAGTAGATAGGA
CCGGGATGGGCGTACCCCGTCCGT -> CGGGATGGGCGTACCCCGTCCGTA
TGCCATAGACTTATACCACATTTG -> GCCATAGACTTATACCACATTTGT
TAGTAATTTTCCACAACCTAGAAG -> AGTAATTTTCCACAACCTAGAAGC
TCTTCCGGGCAAGCACATTGAGAC -> CTTCCGGGCAAGCACATTGAGACT
TTTTTCTTCCGGGGACGGCTTAAA -> TTTTCTTCCGGGGACGGCTTAAAG
CTACGTCAGAGGCCGAGAGCTACC -> TACGTCAGAGGCCGAGAGCTACCC
GATCATTTTATCGATTTTAGATCA -> ATCATTTTATCGATTTTAGATCAC
AAGATAGTTAACGCTGAGGGACCA -> AGATAGTTAACGCTGAGGGACCAC
TGTAACTAGTAATTTTCCACAACC -> GTAACTAGTAATTTTCCACAACCT
CCGCTAACTGAATGGATCGACGTT -> CGCTAACTGAATGGATCGACGTTG
AGGTGACTGGATGGCGTAGGCCAT -> GGTGACTGGATGGCGTAGGCCATT
TCAGAGGCCGAGAGCTACCCTCCC -> CAGAGGCCGAGAGCTACCCTCCCC
TCGGCGTGCTCCTCACGCGGAAGC -> CGGCGTGCTCCTCACGCGGAAGCT
CGTGTACTCGACCTGTAGAGTACG -> GTGTACTCGACCTGTAGAGTACGG
CGGTTCCGTACGTTCTCGAAAGCT -> GGTTCCGTACGTTCTCGAAAGCTC
GGGCTTGGTATCCATAAACTCGTG -> GGCTTGGTATCCATAAACTCGTGT
TCCCTAGCCCAGCGCAACAGTTAG -> CCCTAGCCCAGCGCAACAGTTAGG
TTTGACGTACGAAAGATAGTTAAC -> TTGACGTACGAAAGATAGTTAACG
AAGCCGCTAACAATTCGATAGTTA -> AGCCGCTAACAATTCGATAGTTAT
GTACGAAAGATAGTTAACGCTGAG -> TACGAAAGATAGTTAACGCTGAGG
GGATCGACGTTGCTCATTATCGAG -> GATCGACGTTGCTCATTATCGAGG
ACGGTCCTCAGTATTATCCTTAGT -> CGGTCCTCAGTATTATCCTTAGTT
TCCCAATGTTTGTGGTAAAAGTAG -> CCCAATGTTTGTGGTAAAAGTAGG
CGTTGCTCATTATCGAGGGCCTAT -> GTTGCTCATTATCGAGGGCCTATA
ATTGCTCGTCGACTAAGTTCATCG -> TTGCTCGTCGACTAAGTTCATCGC
AGAGAATTCGAGCAATAAATTAGT -> GAGAATTCGAGCAATAAATTAGTG
TTTCTTCCGGGGACGGCTTAAAGA -> TTCTTCCGGGGACGGCTTAAAGAG
ACATCCGGGATGGGCGTACCCCGT -> CATCCGGGATGGGCGTACCCCGTC
TAGTGTAACTAGTAATTTTCCACA -> AGTGTAACTAGTAATTTTCCACAA
TACTAATTGCTCGTCGACTAAGTT -> ACTAATTGCTCGTCGACTAAGTTC
TACTTCAATTTTAGGAAACCGTTT -> ACTTCAATTTTAGGAAACCGTTTT
CCATCTCCAGGAAGTGTTGCTGAC -> CATCTCCAGGAAGTGTTGCTGACC
TCTATCCTAACCGTCGTGCATGGC -> CTATCCTAACCGTCGTGCATGGCC
ACTCTAGCGTGTCTACGTCAGAGG -> CTCTAGCGTGTCTACGTCAGAGGC
CAGTATTATCCTTAGTTTCCCTAG -> AGTATTATCCTTAGTTTCCCTAGC
GTACTAATTGCTCGTCGACTAAGT -> TACTAATTGCTCGTCGACTAAGTT
GAGGTATTTATGTTTATGAGTGAA -> AGGTATTTATGTTTATGAGTGAAT
CGCTGCCTTGCACCCGTGATAGCC -> GCTGCCTTGCACCCGTGATAGCCG
TGTAGAGTACGGTCCCTTTCGGAT -> GTAGAGTACGGTCCCTTTCGGATA
TCGTGCATGGCCTTCCACAAACGT -> CGTGCATGGCCTTCCACAAACGTG
CCGCCATGGAGGGCAAGCCCTCAC -> CGCCATGGAGGGCAAGCCCTCACC
TGACGACCAGGTGCAAGGCTCCTT -> GACGACCAGGTGCAAGGCTCCTTT
AAGCAATCCATATCTTACTCAGTG -> AGCAATCCATATCTTACTCAGTGT
CCTCAGGCTACAGGAATGAATCTG -> CTCAGGCTACAGGAATGAATCTGT
TGTACTCTCTGGGGTATGGCTACA -> GTACTCTCTGGGGTATGGCTACAC
TTTTAAGCGGGATTCAGTGCCAAG -> TTTAAGCGGGATTCAGTGCCAAGC
CTCACGCGGAAGCTACGTATTCCG -> TCACGCGGAAGCTACGTATTCCGC
TCGATAGTTATCATATGTCGGCTC -> CGATAGTTATCATATGTCGGCTCG
TTAGGAAACCGTTTTAGGGATGCT -> TAGGAAACCGTTTTAGGGATGCTA
GCCGAGAGCTACCCTCCCCGCCAT -> CCGAGAGCTACCCTCCCCGCCATG
CCAGCGCAACAGTTAGGACACAAC -> CAGCGCAACAGTTAGGACACAACA
GGGGTTTGGTCCACGTGACGACCA -> GGGTTTGGTCCACGTGACGACCAG
CCGCTGCCTTGCACCCGTGATAGC -> CGCTGCCTTGCACCCGTGATAGCC
CTGCCATAGACTTATACCACATTT -> TGCCATAGACTTATACCACATTTG
AAGCCGTAGTAGGTGTGTATTATC -> AGCCGTAGTAGGTGTGTATTATCA
ACTGAAAGTTCTATCCTAACCGTC -> CTGAAAGTTCTATCCTAACCGTCG
CCGATCATTTTATCGATTTTAGAT -> CGATCATTTTATCGATTTTAGATC
GGCCGTCGACGGGTCATGAGATCA -> GCCGTCGACGGGTCATGAGATCAG
AGCAATAAATTAGTGTAACTAGTA -> GCAATAAATTAGTGTAACTAGTAA
GTGTCGGCCCGATCATTTTATCGA -> TGTCGGCCCGATCATTTTATCGAT
CTGAGTTATTGGGGCTATGGCGGT -> TGAGTTATTGGGGCTATGGCGGTC
TCAAGCAGATTCGGGGCGGTGCAC -> CAAGCAGATTCGGGGCGGTGCACA
TAAATTAGTGTAACTAGTAATTTT -> AAATTAGTGTAACTAGTAATTTTC
GAGTTATTGGGGCTATGGCGGTCG -> AGTTATTGGGGCTATGGCGGTCGC
GCCAAGCCGTAGTAGGTGTGTATT -> CCAAGCCGTAGTAGGTGTGTATTA
CTAGCCCAGCGCAACAGTTAGGAC -> TAGCCCAGCGCAACAGTTAGGACA
GATAGGGGCTTGGTATCCATAAAC -> ATAGGGGCTTGGTATCCATAAACT
GATGGGCGTACCCCGTCCGTACAA -> ATGGGCGTACCCCGTCCGTACAAG
TTATACCACATTTGTTGGAGTTAT -> TATACCACATTTGTTGGAGTTATG
GCCGTAGTAGGTGTGTATTATCAG -> CCGTAGTAGGTGTGTATTATCAGG
GCAGATTACGAGGACGTCTTAGTT -> CAGATTACGAGGACGTCTTAGTTG
GCATGGCCTTCCACAAACGTGTAC -> CATGGCCTTCCACAAACGTGTACT
TACGTTCTCGAAAGCTCACTGAAA -> ACGTTCTCGAAAGCTCACTGAAAG
CGTGAGCAGATTACGAGGACGTCT -> GTGAGCAGATTACGAGGACGTCTT
CTTGACTCAGGTTGATGCGGATTT -> TTGACTCAGGTTGATGCGGATTTC
AAATTTATCGGCGTGCTCCTCACG -> AATTTATCGGCGTGCTCCTCACGC
ACGCTATCAAGCAGATTCGGGGCG -> CGCTATCAAGCAGATTCGGGGCGG
GGGGTATGGCTACACGTTTGTGAC -> GGGTATGGCTACACGTTTGTGACG
GCCGTAATTCAACAGTATGAGTCG -> CCGTAATTCAACAGTATGAGTCGA
CGCTAACTGAATGGATCGACGTTG -> GCTAACTGAATGGATCGACGTTGC
GTTATTGGGGCTATGGCGGTCGCC -> TTATTGGGGCTATGGCGGTCGCCA
GCCTCTCTGAGAAAGTCTCAACCC -> CCTCTCTGAGAAAGTCTCAACCCC
AGGGTTGCGGTTAGGCGTAATGGA -> GGGTTGCGGTTAGGCGTAATGGAG
AGGTCTGTACTAAGCGGGGCCGTC -> GGTCTGTACTAAGCGGGGCCGTCG
ATGATAAGTAGATAGGAGCCGCGT -> TGATAAGTAGATAGGAGCCGCGTT
ATAGTTAACGCTGAGGGACCACGG -> TAGTTAACGCTGAGGGACCACGGA
CTCGCTACTAAAGGGAGAGTGAAG -> TCGCTACTAAAGGGAGAGTGAAGG
TATCCTTAGTTTCCCTAGCCCAGC -> ATCCTTAGTTTCCCTAGCCCAGCG
TACGAGGACGTCTTAGTTGAATAC -> ACGAGGACGTCTTAGTTGAATACG
TGTATTGGAAGCCGCTAACAATTC -> GTATTGGAAGCCGCTAACAATTCG
TAGCCGCGGTACGTCCCAGGATAA -> AGCCGCGGTACGTCCCAGGATAAC
GCGTGTCTACGTCAGAGGCCGAGA -> CGTGTCTACGTCAGAGGCCGAGAG
GCCATGGAGGGCAAGCCCTCACCG -> CCATGGAGGGCAAGCCCTCACCGC
TGGTCCACGTGACGACCAGGTGCA -> GGTCCACGTGACGACCAGGTGCAA
GAAAGATAGTTAACGCTGAGGGAC -> AAAGATAGTTAACGCTGAGGGACC
CATTTGTTGGAGTTATGATAAGTA -> ATTTGTTGGAGTTATGATAAGTAG
GGCTACAGGAATGAATCTGTTCTT -> GCTACAGGAATGAATCTGTTCTTA
CTTAAAGAGAATTCGAGCAATAAA -> TTAAAGAGAATTCGAGCAATAAAT
ATTTATCGGCGTGCTCCTCACGCG -> TTTATCGGCGTGCTCCTCACGCGG
GCGGATTTCTGACTCGTTGCCGTG -> CGGATTTCTGACTCGTTGCCGTGG
TGTACTCGACCTGTAGAGTACGGT -> GTACTCGACCTGTAGAGTACGGTC
GTTGAATACGTTTACAGGCTCACA -> TTGAATACGTTTACAGGCTCACAT
GGGCAAGCACATTGAGACTACACT -> GGCAAGCACATTGAGACTACACTC
TGACTGGATGGCGTAGGCCATTTG -> GACTGGATGGCGTAGGCCATTTGA
TCAGGCTACAGGAATGAATCTGTT -> CAGGCTACAGGAATGAATCTGTTC
TTTGTTGGAGTTATGATAAGTAGA -> TTGTTGGAGTTATGATAAGTAGAT
CAACAATGTGACACGTGTGTCCCG -> AACAATGTGACACGTGTGTCCCGA
GTCCCAGGATAACCCATGCGTGAT -> TCCCAGGATAACCCATGCGTGATC
TATGAGTCGATTGAACGCTATCAA -> ATGAGTCGATTGAACGCTATCAAG
TAGGAAACCGTTTTAGGGATGCTA -> AGGAAACCGTTTTAGGGATGCTAT
AGCACATTGAGACTACACTCTAGC -> GCACATTGAGACTACACTCTAGCG
ATCCCAATGTTTGTGGTAAAAGTA -> TCCCAATGTTTGTGGTAAAAGTAG
AATTTATCGGCGTGCTCCTCACGC -> ATTTATCGGCGTGCTCCTCACGCG
TCACTCCATTATCCCAATGTTTGT -> CACTCCATTATCCCAATGTTTGTG
CCACGGATCACTCCATTATCCCAA -> CACGGATCACTCCATTATCCCAAT
ACAGGTACTCCTGTGGGGCGGCAA -> CAGGTACTCCTGTGGGGCGGCAAG
CAAGCCCTCACCGCTTTTTCTTCC -> AAGCCCTCACCGCTTTTTCTTCCG
AGATTACGAGGACGTCTTAGTTGA -> GATTACGAGGACGTCTTAGTTGAA
AGGGAGAGTGAAGGTCTGTACTAA -> GGGAGAGTGAAGGTCTGTACTAAG
AGAAAGTCTCAACCCCCTGAGTTA -> GAAAGTCTCAACCCCCTGAGTTAT
GAAGCCGCTAACAATTCGATAGTT -> AAGCCGCTAACAATTCGATAGTTA
CAAGCATGTTTGCGCCGGCAGATT -> AAGCATGTTTGCGCCGGCAGATTT
ACTGAATGGATCGACGTTGCTCAT -> CTGAATGGATCGACGTTGCTCATT
AGCGCTCTGCCATAGACTTATACC -> GCGCTCTGCCATAGACTTATACCA
CAGCTAGGAGGTATTTATGTTTAT -> AGCTAGGAGGTATTTATGTTTATG
GTATTATCCTTAGTTTCCCTAGCC -> TATTATCCTTAGTTTCCCTAGCCC
TATACCACATTTGTTGGAGTTATG -> ATACCACATTTGTTGGAGTTATGA
CATGTTTGCGCCGGCAGATTTCAG -> ATGTTTGCGCCGGCAGATTTCAGG
AGGCCAGGTTGCCATGTGCGGCAG -> GGCCAGGTTGCCATGTGCGGCAGT
ATATGTCGGCTCGCTACTAAAGGG -> TATGTCGGCTCGCTACTAAAGGGA
CCGAGGTAACTTCTTGGACCTCGG -> CGAGGTAACTTCTTGGACCTCGGT
ATTTTAGATCACACAGGTTATATT -> TTTTAGATCACACAGGTTATATTT
TTGGGGCTATGGCGGTCGCCATTG -> TGGGGCTATGGCGGTCGCCATTGT
ATAAACTCGTGTTTCAGAACAGCC -> TAAACTCGTGTTTCAGAACAGCCA
ACAGTATGAGTCGATTGAACGCTA -> CAGTATGAGTCGATTGAACGCTAT
TGCCATGTGCGGCAGTTCCTCATA -> GCCATGTGCGGCAGTTCCTCATAC
GGTGCACACCAGGACATAAGGAGG -> GTGCACACCAGGACATAAGGAGGC
AATTGCTCGTCGACTAAGTTCATC -> ATTGCTCGTCGACTAAGTTCATCG
TTACTCAGTGTCGGCCCGATCATT -> TACTCAGTGTCGGCCCGATCATTT
TGCATGGCCTTCCACAAACGTGTA -> GCATGGCCTTCCACAAACGTGTAC
CCTTAGTTTCCCTAGCCCAGCGCA -> CTTAGTTTCCCTAGCCCAGCGCAA
CTATCAAGCAGATTCGGGGCGGTG -> TATCAAGCAGATTCGGGGCGGTGC
ATCATTTTATCGATTTTAGATCAC -> TCATTTTATCGATTTTAGATCACA
TTCAGTGCCAAGCCGTAGTAGGTG -> TCAGTGCCAAGCCGTAGTAGGTGT
CGGGGTTTGGTCCACGTGACGACC -> GGGGTTTGGTCCACGTGACGACCA
CCGAGCCGCAATCGCGGGTCTTCC -> CGAGCCGCAATCGCGGGTCTTCCG
TGTCGGCTCGCTACTAAAGGGAGA -> GTCGGCTCGCTACTAAAGGGAGAG
ACTAGTAATTTTCCACAACCTAGA -> CTAGTAATTTTCCACAACCTAGAA
ATCCATATCTTACTCAGTGTCGGC -> TCCATATCTTACTCAGTGTCGGCC
GTAACTTCTTGGACCTCGGTTCCG -> TAACTTCTTGGACCTCGGTTCCGT
TGAATACGTTTACAGGCTCACATA -> GAATACGTTTACAGGCTCACATAT
ACCCCGTCCGTACAAGGTTCATAG -> CCCCGTCCGTACAAGGTTCATAGT
TTCTCGAAAGCTCACTGAAAGTTC -> TCTCGAAAGCTCACTGAAAGTTCT
AGCCGTAGTAGGTGTGTATTATCA -> GCCGTAGTAGGTGTGTATTATCAG
AGTGTCGGCCCGATCATTTTATCG -> GTGTCGGCCCGATCATTTTATCGA
ATTTTCCACAACCTAGAAGCCGTA -> TTTTCCACAACCTAGAAGCCGTAA
ATTCAACAGTATGAGTCGATTGAA -> TTCAACAGTATGAGTCGATTGAAC
TGCCGTGGTGTGGCGAATGCACAT -> GCCGTGGTGTGGCGAATGCACATC
ATCGGCGTGCTCCTCACGCGGAAG -> TCGGCGTGCTCCTCACGCGGAAGC
TTGGCAACAATGTGACACGTGTGT -> TGGCAACAATGTGACACGTGTGTC
CTGCCTTGCACCCGTGATAGCCGC -> TGCCTTGCACCCGTGATAGCCGCG
GTACTCGACCTGTAGAGTACGGTC -> TACTCGACCTGTAGAGTACGGTCC
GTTCCTCATACACGTAGCGCTCTG -> TTCCTCATACACGTAGCGCTCTGC
CGGTCGCCATTGTATTGGAAGCCG -> GGTCGCCATTGTATTGGAAGCCGC
AGCCGCGTTGCTCAATATGTACTA -> GCCGCGTTGCTCAATATGTACTAA
AAAGAGAATTCGAGCAATAAATTA -> AAGAGAATTCGAGCAATAAATTAG
AGATCACACAGGTTATATTTTCTC -> GATCACACAGGTTATATTTTCTCA
GTGTGTCCCGATCTGCAGCTAGGA -> TGTGTCCCGATCTGCAGCTAGGAG
CGATTGAACGCTATCAAGCAGATT -> GATTGAACGCTATCAAGCAGATTC
GGCCGAGAGCTACCCTCCCCGCCA -> GCCGAGAGCTACCCTCCCCGCCAT
CCTGAGTTATTGGGGCTATGGCGG -> CTGAGTTATTGGGGCTATGGCGGT
AATATGTACTAATTGCTCGTCGAC -> ATATGTACTAATTGCTCGTCGACT
TGATAGCCGCGGTACGTCCCAGGA -> GATAGCCGCGGTACGTCCCAGGAT
TCTTAGTTGAATACGTTTACAGGC -> CTTAGTTGAATACGTTTACAGGCT
CTGTCTTGACTCCTCAGATTCTGT -> TGTCTTGACTCCTCAGATTCTGTC
ATTTGTTGGAGTTATGATAAGTAG -> TTTGTTGGAGTTATGATAAGTAGA
AGTGTAACTAGTAATTTTCCACAA -> GTGTAACTAGTAATTTTCCACAAC
CACATATAGTTCGTACATACTTCA -> ACATATAGTTCGTACATACTTCAA
CGAAAGATAGTTAACGCTGAGGGA -> GAAAGATAGTTAACGCTGAGGGAC
GATTACGAGGACGTCTTAGTTGAA -> ATTACGAGGACGTCTTAGTTGAAT
CCTCCCCGCCATGGAGGGCAAGCC -> CTCCCCGCCATGGAGGGCAAGCCC
GTGAGACAGGTACTCCTGTGGGGC -> TGAGACAGGTACTCCTGTGGGGCG
GGACGTCTTAGTTGAATACGTTTA -> GACGTCTTAGTTGAATACGTTTAC
GGAAAGAACCATCATACGGTCCTC -> GAAAGAACCATCATACGGTCCTCA
CTGGATGGCGTAGGCCATTTGACG -> TGGATGGCGTAGGCCATTTGACGT
CGGATAGGGGCTTGGTATCCATAA -> GGATAGGGGCTTGGTATCCATAAA
TCCCTTTCGGATAGGGGCTTGGTA -> CCCTTTCGGATAGGGGCTTGGTAT
TATCAGGTGACTGGATGGCGTAGG -> ATCAGGTGACTGGATGGCGTAGGC
TTGTGGTAAAAGTAGGGTTGCGGT -> TGTGGTAAAAGTAGGGTTGCGGTT
TCGCGGAATTGTACTCTCTGGGGT -> CGCGGAATTGTACTCTCTGGGGTA
TTAGTTGAATACGTTTACAGGCTC -> TAGTTGAATACGTTTACAGGCTCA
AGTATGAGTCGATTGAACGCTATC -> GTATGAGTCGATTGAACGCTATCA
TAACGCTGAGGGACCACGGATCAC -> AACGCTGAGGGACCACGGATCACT
CGCTAAATCACCCGTGGATAGTGT -> GCTAAATCACCCGTGGATAGTGTC
CAGGAATGAATCTGTTCTTACTAA -> AGGAATGAATCTGTTCTTACTAAA
CCTGTAGAGTACGGTCCCTTTCGG -> CTGTAGAGTACGGTCCCTTTCGGA
TCGACTAAGTTCATCGCGGAATTG -> CGACTAAGTTCATCGCGGAATTGT
ACGTTTGTGACGCTAAATCACCCG -> CGTTTGTGACGCTAAATCACCCGT
AACAGCCAACCTGCATACACCACT -> ACAGCCAACCTGCATACACCACTT
TGAATGAACCCATCTCCAGGAAGT -> GAATGAACCCATCTCCAGGAAGTG
GAGCCGCGTTGCTCAATATGTACT -> AGCCGCGTTGCTCAATATGTACTA
CGTACCCCGTCCGTACAAGGTTCA -> GTACCCCGTCCGTACAAGGTTCAT
CATCGCGGAATTGTACTCTCTGGG -> ATCGCGGAATTGTACTCTCTGGGG
TCCTCACGCGGAAGCTACGTATTC -> CCTCACGCGGAAGCTACGTATTCC
CTAAACTACTGTCTTGACTCCTCA -> TAAACTACTGTCTTGACTCCTCAG
CCGGGGTTTGGTCCACGTGACGAC -> CGGGGTTTGGTCCACGTGACGACC
TTCAGGAAAGAACCATCATACGGT -> TCAGGAAAGAACCATCATACGGTC
CGCGGAAGCTACGTATTCCGCTAA -> GCGGAAGCTACGTATTCCGCTAAC
GGAATTGTACTCTCTGGGGTATGG -> GAATTGTACTCTCTGGGGTATGGC
TGGTAAAAGTAGGGTTGCGGTTAG -> GGTAAAAGTAGGGTTGCGGTTAGG
GCTACAGGAATGAATCTGTTCTTA -> CTACAGGAATGAATCTGTTCTTAC
ACGTTGCTCATTATCGAGGGCCTA -> CGTTGCTCATTATCGAGGGCCTAT
CTCGTTGCCGTGGTGTGGCGAATG -> TCGTTGCCGTGGTGTGGCGAATGC
AATAAATTAGTGTAACTAGTAATT -> ATAAATTAGTGTAACTAGTAATTT
AGTACGGTCCCTTTCGGATAGGGG -> GTACGGTCCCTTTCGGATAGGGGC
TAAGTTCATCGCGGAATTGTACTC -> AAGTTCATCGCGGAATTGTACTCT
CAACACCAAGACACTTGTGGCGAC -> AACACCAAGACACTTGTGGCGACG
GTTACTCGCCTCTCTGAGAAAGTC -> TTACTCGCCTCTCTGAGAAAGTCT
AACCTAGAAGCCGTAATTCAACAG -> ACCTAGAAGCCGTAATTCAACAGT
GCTATCGCCGGGGTTTGGTCCACG -> CTATCGCCGGGGTTTGGTCCACGT
GCTCACTGAAAGTTCTATCCTAAC -> CTCACTGAAAGTTCTATCCTAACC
AACGCGCCGTGAGCAGATTACGAG -> ACGCGCCGTGAGCAGATTACGAGG
GTGTGGCGAATGCACATCCGGGAT -> TGTGGCGAATGCACATCCGGGATG
ATGAGATCAGAAACGCGCCGTGAG -> TGAGATCAGAAACGCGCCGTGAGC
CGCCCATCCGCTGCCTTGCACCCG -> GCCCATCCGCTGCCTTGCACCCGT
TACAGTTACTCGCCTCTCTGAGAA -> ACAGTTACTCGCCTCTCTGAGAAA
CCCAGCGCAACAGTTAGGACACAA -> CCAGCGCAACAGTTAGGACACAAC
TCCTCATACACGTAGCGCTCTGCC -> CCTCATACACGTAGCGCTCTGCCA
AGTACGTTTTTAAGCGGGATTCAG -> GTACGTTTTTAAGCGGGATTCAGT
GTTCATAGTACGTTTTTAAGCGGG -> TTCATAGTACGTTTTTAAGCGGGA
TCACCGCTTTTTCTTCCGGGGACG -> CACCGCTTTTTCTTCCGGGGACGG
GACAGGTACTCCTGTGGGGCGGCA -> ACAGGTACTCCTGTGGGGCGGCAA
GCTACCCTCCCCGCCATGGAGGGC -> CTACCCTCCCCGCCATGGAGGGCA
TGGCGAATGCACATCCGGGATGGG -> GGCGAATGCACATCCGGGATGGGC
GGTTCATAGTACGTTTTTAAGCGG -> GTTCATAGTACGTTTTTAAGCGGG
TCCTTTCCGCCCATCCGCTGCCTT -> CCTTTCCGCCCATCCGCTGCCTTG
TGGAGTTATGATAAGTAGATAGGA -> GGAGTTATGATAAGTAGATAGGAG
AGGATAACCCATGCGTGATCCGAG -> GGATAACCCATGCGTGATCCGAGC
ACGGATCACTCCATTATCCCAATG -> CGGATCACTCCATTATCCCAATGT
CGAGAGCTACCCTCCCCGCCATGG -> GAGAGCTACCCTCCCCGCCATGGA
CCACATTTGTTGGAGTTATGATAA -> CACATTTGTTGGAGTTATGATAAG
GACGGCTTAAAGAGAATTCGAGCA -> ACGGCTTAAAGAGAATTCGAGCAA
CGTGTGTCCCGATCTGCAGCTAGG -> GTGTGTCCCGATCTGCAGCTAGGA
TTTCAGGAAAGAACCATCATACGG -> TTCAGGAAAGAACCATCATACGGT
TCGGGGCGGTGCACACCAGGACAT -> CGGGGCGGTGCACACCAGGACATA
GAATGAACCCATCTCCAGGAAGTG -> AATGAACCCATCTCCAGGAAGTGT
GGAAGCTACGTATTCCGCTAACTG -> GAAGCTACGTATTCCGCTAACTGA
CCATTGTATTGGAAGCCGCTAACA -> CATTGTATTGGAAGCCGCTAACAA
GTGATCCGAGCCGCAATCGCGGGT -> TGATCCGAGCCGCAATCGCGGGTC
GTTGCTGACCCGTCTTGAGGCCTT -> TTGCTGACCCGTCTTGAGGCCTTG
ACATTGAGACTACACTCTAGCGTG -> CATTGAGACTACACTCTAGCGTGT
CACGTAGCGCTCTGCCATAGACTT -> ACGTAGCGCTCTGCCATAGACTTA
TTGCTCATTATCGAGGGCCTATAT -> TGCTCATTATCGAGGGCCTATATA
AATTCGATAGTTATCATATGTCGG -> ATTCGATAGTTATCATATGTCGGC
TGACTCCTCAGATTCTGTCTATCA -> GACTCCTCAGATTCTGTCTATCAA
ATCAATCCTGCCCCGAGGTAACTT -> TCAATCCTGCCCCGAGGTAACTTC
AAAGTTCTATCCTAACCGTCGTGC -> AAGTTCTATCCTAACCGTCGTGCA
CGTACAAGGTTCATAGTACGTTTT -> GTACAAGGTTCATAGTACGTTTTT
CCCTAGCCCAGCGCAACAGTTAGG -> CCTAGCCCAGCGCAACAGTTAGGA
CCGGCAGATTTCAGGAAAGAACCA -> CGGCAGATTTCAGGAAAGAACCAT
GTATTATCAGGTGACTGGATGGCG -> TATTATCAGGTGACTGGATGGCGT
ATTCGGGGCGGTGCACACCAGGAC -> TTCGGGGCGGTGCACACCAGGACA
CACCCGTGGATAGTGTCAAATTTA -> ACCCGTGGATAGTGTCAAATTTAT
ATTCGAGCAATAAATTAGTGTAAC -> TTCGAGCAATAAATTAGTGTAACT
GGCAAGCTTACAGTTACTCGCCTC -> GCAAGCTTACAGTTACTCGCCTCT
AGACACTTGTGGCGACGAGGGAGG -> GACACTTGTGGCGACGAGGGAGGT
ATGGAGGGCAAGCCCTCACCGCTT -> TGGAGGGCAAGCCCTCACCGCTTT
GACGAGGGAGGTGAGACAGGTACT -> ACGAGGGAGGTGAGACAGGTACTC
TCAGTGCCAAGCCGTAGTAGGTGT -> CAGTGCCAAGCCGTAGTAGGTGTG
TGCAGCTAGGAGGTATTTATGTTT -> GCAGCTAGGAGGTATTTATGTTTA
ATAGTTATCATATGTCGGCTCGCT -> TAGTTATCATATGTCGGCTCGCTA
CATTTGACGTACGAAAGATAGTTA -> ATTTGACGTACGAAAGATAGTTAA
TGGGGCTATGGCGGTCGCCATTGT -> GGGGCTATGGCGGTCGCCATTGTA
AGGGCAAGCCCTCACCGCTTTTTC -> GGGCAAGCCCTCACCGCTTTTTCT
GACGTCTTAGTTGAATACGTTTAC -> ACGTCTTAGTTGAATACGTTTACA
TGTGTCCCGATCTGCAGCTAGGAG -> GTGTCCCGATCTGCAGCTAGGAGG
TATCCTAACCGTCGTGCATGGCCT -> ATCCTAACCGTCGTGCATGGCCTT
CGTTTTAGGGATGCTATCGCCGGG -> GTTTTAGGGATGCTATCGCCGGGG
CCGATCTGCAGCTAGGAGGTATTT -> CGATCTGCAGCTAGGAGGTATTTA
TTTCCACAACCTAGAAGCCGTAAT -> TTCCACAACCTAGAAGCCGTAATT
TAGAAGCCGTAATTCAACAGTATG -> AGAAGCCGTAATTCAACAGTATGA
CATGTGCGGCAGTTCCTCATACAC -> ATGTGCGGCAGTTCCTCATACACG
AGTATTATCCTTAGTTTCCCTAGC -> GTATTATCCTTAGTTTCCCTAGCC
